word                           	 ipa                            	 ipa_model                      
uremia                         	 jərimiə                        	 jərimiə                       
fishbowls                      	 fishbowls*                     	 fɪʃboʊlz                      
kreese                         	 kreese*                        	 kris                          
bombe                          	 bombe*                         	 bɑm                           
seediness                      	 seediness*                     	 sidinəs                       
intuit                         	 ɪntuət                         	 ɪntuət                        
architecturally                	 ɑrkɪtɛkʧərəli                  	 ɑrkətɛkʧərəli                 
shea                           	 ʃe                             	 ʃi                            
storybook                      	 stɔribʊk                       	 stɔribʊk                      
melodrama                      	 mɛlədrɑmə                      	 mɛlədrɑmə                     
lapels                         	 ləpɛlz                         	 ləpɛlz                        
affair                         	 əfɛr                           	 əfɛr                          
bodacious                      	 bodacious*                     	 bɑdeʃəs                       
unsettlement                   	 unsettlement*                  	 ənsɛtəlmənt                   
erg                            	 erg*                           	 ərg                           
asap                           	 esæp                           	 əsæp                          
ague                           	 ague*                          	 eg                            
pk                             	 pk*                            	 pk                            
negotiation                    	 nɪgoʊʃieʃən                    	 nɪgoʊʃieʃən                   
sonar                          	 soʊnɑr                         	 soʊnɑr                        
behaving                       	 bɪhevɪŋ                        	 bɪhevɪŋ                       
quadriceps                     	 kwɑdrəsɛps                     	 kwɑdrəsɛps                    
lits                           	 lɪts                           	 lɪts                          
comparison                     	 kəmpɛrəsən                     	 kəmpɛrəsən                    
kultur                         	 kultur*                        	 kəlʧər                        
microscopic                    	 maɪkrəskɑpɪk                   	 maɪkrəskɑpɪk                  
pneumonia                      	 nəmoʊnjə                       	 nəmoʊnjə                      
verity                         	 vɛrɪti                         	 vɛrɪti                        
widest                         	 waɪdəst                        	 waɪdəst                       
naughtiness                    	 naughtiness*                   	 nɔtɪnəs                       
footings                       	 fʊtɪŋz                         	 fʊtɪŋz                        
lockup                         	 lɑkəp                          	 lɑkəp                         
trammel                        	 træməl                         	 træməl                        
urticaria                      	 urticaria*                     	 ərtɪkɛriə                     
prob                           	 prɑb                           	 prɑb                          
rework                         	 riwərk                         	 riwərk                        
curette                        	 curette*                       	 kjʊrət                        
elling                         	 ɛlɪŋ                           	 ɛlɪŋ                          
ermine                         	 ərmən                          	 ərmən                         
kikes                          	 kikes*                         	 kaɪks                         
essay                          	 ɛse                            	 ɛse                           
intern                         	 ɪntərn                         	 ɪntərn                        
systemized                     	 systemized*                    	 sɪstəmaɪzd                    
broomsticks                    	 brumstɪks                      	 brumstɪks                     
zanzibar                       	 zænzəbɑr                       	 zænzəbɑr                      
moxie                          	 mɑksi                          	 mɑksi                         
barbules                       	 barbules*                      	 bɑrbjulz                      
pincushions                    	 pincushions*                   	 pənkʊʃənz                     
extravagance                   	 ɛkstrævəgəns                   	 ɛkstrævəgəns                  
hypoxemia                      	 hypoxemia*                     	 haɪpɑksiə                     
dentals                        	 dɛntəlz                        	 dɛntəlz                       
stitching                      	 stɪʧɪŋ                         	 stɪʧɪŋ                        
fidgety                        	 fidgety*                       	 fɪʤəti                        
overspread                     	 overspread*                    	 oʊvərsprɛd                    
frights                        	 frights*                       	 fraɪts                        
stolid                         	 stɑləd                         	 stɑləd                        
pretension                     	 pritɛnʃən                      	 pritɛnʃən                     
maligned                       	 məlaɪnd                        	 məlaɪnd                       
joying                         	 ʤɔɪɪŋ                          	 ʤɔɪɪŋ                         
dunny                          	 dunny*                         	 dəni                          
stowaways                      	 stoʊəwez                       	 stoʊəwez                      
veal                           	 vil                            	 vil                           
smokestack                     	 smoʊkstæk                      	 smoʊkstæk                     
pinniped                       	 pinniped*                      	 pɪnɪpt                        
frere                          	 frɪr                           	 frɛr                          
heigh                          	 heigh*                         	 haɪ                           
holed                          	 hoʊld                          	 hoʊld                         
magus                          	 magus*                         	 megəs                         
stellate                       	 stellate*                      	 stɛlət                        
unenthused                     	 unenthused*                    	 ənɛnθuzd                      
construed                      	 kənstrud                       	 kənstrud                      
broader                        	 brɔdər                         	 brɔdər                        
scaffolded                     	 scaffolded*                    	 skæfəldɪd                     
immoderate                     	 immoderate*                    	 ɪmɑdəret                      
valediction                    	 valediction*                   	 vælədɪkʃən                    
usefully                       	 jusfəli                        	 jusfəli                       
ignoramus                      	 ɪgnəreməs                      	 ɪgnəreməs                     
entendre                       	 ɑntɑndrə                       	 ɛnəndr                        
lives                          	 lɪvz                           	 lɪvz                          
founded                        	 faʊndɪd                        	 faʊndɪd                       
hamstrung                      	 hæmstrəŋ                       	 hæmstrəŋ                      
materialist                    	 mətɪriəlɪst                    	 mətɪriəlɪst                   
obstacles                      	 ɑbstəkəlz                      	 ɑbstəkəlz                     
wools                          	 wʊlz                           	 wʊlz                          
pia                            	 piə                            	 piə                           
virtuosos                      	 virtuosos*                     	 vərʧuoʊsoʊ                    
retyped                        	 retyped*                       	 ritaɪpt                       
streamlining                   	 strimlaɪnɪŋ                    	 strimlaɪnɪŋ                   
whisperers                     	 wɪspərərz                      	 wɪspərərz                     
outdrew                        	 outdrew*                       	 aʊtdru                        
golpe                          	 golpe*                         	 gɑlp                          
bundt                          	 bundt*                         	 bəndt                         
jackals                        	 jackals*                       	 ʤækəlz                        
shoals                         	 ʃoʊlz                          	 ʃoʊlz                         
obscurity                      	 əbskjʊrəti                     	 əbskjʊrəti                    
gusset                         	 gusset*                        	 gəsɪt                         
cabalist                       	 cabalist*                      	 kəbɑləst                      
affectionate                   	 əfɛkʃənət                      	 əfɛkʃənət                     
trifled                        	 trifled*                       	 traɪfəld                      
outlawry                       	 aʊtlɔri                        	 aʊtlɔri                       
tilly                          	 tɪli                           	 tɪli                          
homilies                       	 hoʊməliz                       	 hoʊməliz                      
insinuation                    	 ɪnsɪnjueʃən                    	 ɪnsɪnjueʃən                   
istanbul                       	 ɪstɑnbul                       	 ɪstɑnbul                      
richter                        	 rɪktər                         	 rɪʧtər                        
buckland                       	 bəklənd                        	 bəklænd                       
sizing                         	 saɪzɪŋ                         	 saɪzɪŋ                        
denounce                       	 dɪnaʊns                        	 dɪnaʊns                       
vigilant                       	 vɪʤələnt                       	 vɪʤələnt                      
tane                           	 tane*                          	 ten                           
harangued                      	 həræŋd                         	 həræŋd                        
reprocessed                    	 riprɔsɛst                      	 riprɔsɛst                     
boogieing                      	 boogieing*                     	 buʤiɪŋ                        
adulteress                     	 adulteress*                    	 ədəltərɪs                     
chorusing                      	 chorusing*                     	 ʧɔrusɪŋ                       
introducer                     	 introducer*                    	 ɪntrədusər                    
reggae                         	 rɛge                           	 rɛge                          
podesta                        	 poʊdɛstə                       	 poʊdəstə                      
iowa                           	 aɪəwə                          	 aɪə                           
unclick                        	 unclick*                       	 ənklɪk                        
conchological                  	 conchological*                 	 kɑnʃəlɑʤɪkəl                  
cuisines                       	 kwɪzinz                        	 kwɪzinz                       
bonuses                        	 boʊnəsɪz                       	 boʊnəsɪz                      
imperatives                    	 ɪmpɛrətɪvz                     	 ɪmpɛrətɪvz                    
sodomy                         	 sɑdəmi                         	 sɔdəmi                        
hallel                         	 hallel*                        	 hæləl                         
foxtrots                       	 foxtrots*                      	 fɑkstrɑts                     
floundering                    	 flaʊndərɪŋ                     	 flaʊndərɪŋ                    
midfielder                     	 midfielder*                    	 mɪdfildər                     
cod                            	 sioʊdi                         	 sioʊdi                        
wassail                        	 wassail*                       	 wɑsel                         
organized                      	 ɔrgənaɪzd                      	 ɔrgənaɪzd                     
expulsive                      	 expulsive*                     	 ɪkspəlsɪv                     
psychotic                      	 saɪkɑtɪk                       	 saɪkɑtɪk                      
constitution                   	 kɑnstətuʃən                    	 kɑnstətuʃən                   
compere                        	 compere*                       	 kəmpɪr                        
sluttiest                      	 sluttiest*                     	 slətiəst                      
googling                       	 guglɪŋ                         	 guglɪŋ                        
nonintervention                	 nɑnɪntərvɛnʃən                 	 nɑnɪntərvɛnʃən                
sart                           	 sart*                          	 sɑrt                          
longue                         	 longue*                        	 lɔŋg                          
skee                           	 skee*                          	 ski                           
froggies                       	 froggies*                      	 frɑgiz                        
mothership                     	 məðərʃɪp                       	 məðərʃɪp                      
falsifies                      	 falsifies*                     	 fɔlsəfaɪz                     
striae                         	 striae*                        	 stri                          
craniums                       	 craniums*                      	 kreniəmz                      
imprinting                     	 ɪmprɪnɪŋ                       	 ɪmprɪnɪŋ                      
implore                        	 ɪmplɔr                         	 ɪmplɔr                        
monopolised                    	 monopolised*                   	 mənɑpəlaɪzd                   
malevolence                    	 malevolence*                   	 məlɛvələns                    
father                         	 fɑðər                          	 fɑðər                         
dram                           	 diræm                          	 dræm                          
sateen                         	 sateen*                        	 setən                         
pervert                        	 pərvərt                        	 pərvərt                       
boat                           	 boʊt                           	 boʊt                          
blue                           	 blu                            	 blu                           
oohed                          	 oohed*                         	 ud                            
irritable                      	 ɪrətəbəl                       	 ɪrətəbəl                      
mistreat                       	 mɪstrit                        	 mɪstrit                       
seminoles                      	 sɛmɪnoʊlz                      	 sɛmənoʊlz                     
emphasize                      	 ɛmfəsaɪz                       	 ɛmfəsaɪz                      
swear                          	 swɛr                           	 swɛr                          
buckles                        	 bəkəlz                         	 bəkəlz                        
complaints                     	 kəmplents                      	 kəmplents                     
prophetess                     	 prɑfətəs                       	 prɑfətəs                      
neutralization                 	 nutrələzeʃən                   	 nutrəleʃən                    
gear                           	 gɪr                            	 gɪr                           
reduces                        	 rɪdusɪz                        	 rɪdusɪz                       
greenhorn                      	 greenhorn*                     	 grinhɔrn                      
parked                         	 pɑrkt                          	 pɑrkt                         
overjoyous                     	 overjoyous*                    	 oʊvərʤɔɪəs                    
grandpa                        	 grændpɑ                        	 grændpɑ                       
grommets                       	 grommets*                      	 grɑməts                       
pilothouse                     	 pilothouse*                    	 paɪləθəs                      
nether                         	 nɛðər                          	 nɛðər                         
fixed                          	 fɪkst                          	 fɪkst                         
uncontroversial                	 ənkɑntrəvərʃəl                 	 ənkɑntrəvərʃəl                
etna                           	 ɛtnə                           	 ɛtnə                          
trilobites                     	 trilobites*                    	 trɪləbaɪts                    
turkey                         	 tərki                          	 tərki                         
complicating                   	 kɑmpləketɪŋ                    	 kɑmpləketɪŋ                   
beanbag                        	 beanbag*                       	 binbæg                        
skivvies                       	 skivvies*                      	 skɪviz                        
adenoid                        	 ædənɔɪd                        	 ædənɔɪd                       
owning                         	 oʊnɪŋ                          	 oʊnɪŋ                         
antinuclear                    	 antinuclear*                   	 æntinəkələr                   
fumble                         	 fəmbəl                         	 fəmbəl                        
atty                           	 atty*                          	 ətaɪ                          
torsos                         	 tɔrsoʊz                        	 tɔrsəs                        
dynasties                      	 daɪnəstiz                      	 daɪnəstiz                     
gooding                        	 gʊdɪŋ                          	 gʊdɪŋ                         
wrath                          	 ræθ                            	 ræθ                           
churching                      	 churching*                     	 ʧərʧɪŋ                        
screech                        	 skriʧ                          	 skriʧ                         
result                         	 rɪzəlt                         	 rɪzəlt                        
donkey                         	 dɔŋki                          	 dɔŋki                         
revise                         	 rɪvaɪz                         	 rɪvaɪz                        
ragtag                         	 rægtæg                         	 rægtæg                        
treatise                       	 tritəs                         	 tritəs                        
borzoi                         	 borzoi*                        	 bɔrzoʊ                        
lessor                         	 lɛsər                          	 lɛsər                         
civilizes                      	 civilizes*                     	 səvɪləzɪz                     
bullfrog                       	 bʊlfrɔg                        	 bʊlfrɔg                       
pedigree                       	 pɛdəgri                        	 pɛdəgri                       
tikkun                         	 tikkun*                        	 tɪkən                         
photocopies                    	 foʊtoʊkɑpiz                    	 foʊtoʊkɑpiz                   
refreeze                       	 refreeze*                      	 rifriz                        
grossest                       	 grossest*                      	 groʊsɛst                      
toru                           	 tɔru                           	 tɔru                          
pinscher                       	 pinscher*                      	 pɪnsʧər                       
deescalate                     	 deescalate*                    	 diskəlet                      
susan                          	 suzən                          	 susən                         
creeds                         	 kridz                          	 kridz                         
queue                          	 kju                            	 kju                           
reprobates                     	 reprobates*                    	 rɛprɔbets                     
betties                        	 betties*                       	 bɛtiz                         
djakarta                       	 ʤəkɑrtə                        	 dʤəkɑrtə                      
sherry                         	 ʃɛri                           	 ʃɛri                          
kook                           	 kuk                            	 kʊk                           
protestations                  	 proʊtɛsteʃənz                  	 proʊtɛsteʃənz                 
seamy                          	 simi                           	 simi                          
leeways                        	 leeways*                       	 liwez                         
brooder                        	 brooder*                       	 brudər                        
boarded                        	 bɔrdɪd                         	 bɔrdɪd                        
purchaser                      	 pərʧəsər                       	 pərʧəsər                      
copycat                        	 kɑpikæt                        	 kɑpikæt                       
pileup                         	 paɪləp                         	 paɪləp                        
sellers                        	 sɛlərz                         	 sɛlərz                        
douche                         	 duʃ                            	 duʃ                           
portable                       	 pɔrtəbəl                       	 pɔrtəbəl                      
scoping                        	 skoʊpɪŋ                        	 skoʊpɪŋ                       
tumbly                         	 tumbly*                        	 təmbli                        
darby                          	 dɑrbi                          	 dɑrbi                         
global                         	 gloʊbəl                        	 gloʊbəl                       
machin                         	 mæʧɪn                          	 məʃin                         
petition                       	 pətɪʃən                        	 pətɪʃən                       
premium                        	 primiəm                        	 primiəm                       
epaulet                        	 epaulet*                       	 ɛpəle                         
cameroon                       	 kæmərun                        	 kæmərun                       
flicker                        	 flɪkər                         	 flɪkər                        
oarsman                        	 ɔrzmən                         	 ɔrzmən                        
restriction                    	 ristrɪkʃən                     	 ristrɪkʃən                    
interagency                    	 ɪntəreʤənsi                    	 ɪnərɪʤənsi                    
tachycardiac                   	 tachycardiac*                  	 tæʧɪkɑrdiæk                   
closeup                        	 kloʊsəp                        	 kloʊsəp                       
stubby                         	 stəbi                          	 stəbi                         
unburnt                        	 unburnt*                       	 ənbərnt                       
closetful                      	 closetful*                     	 kloʊsɛtfəl                    
dissociation                   	 dɪsoʊsieʃən                    	 dɪsoʊʃieʃən                   
dirk                           	 dərk                           	 dərk                          
wainwright                     	 wenraɪt                        	 wenraɪt                       
inseparable                    	 ɪnsɛpərəbəl                    	 ɪnsɛpərəbəl                   
pluviosity                     	 pluviosity*                    	 pluvaɪɑsəti                   
alienate                       	 eljənet                        	 eljənet                       
loros                          	 loros*                         	 loʊroʊz                       
compelled                      	 kəmpɛld                        	 kəmpɛld                       
matting                        	 mætɪŋ                          	 mætɪŋ                         
shrugged                       	 ʃrəgd                          	 ʃrəgd                         
prosecutor                     	 prɑsɪkjutər                    	 prɑsɪkjutər                   
scree                          	 scree*                         	 skri                          
dallis                         	 dallis*                        	 dælɪs                         
unseemly                       	 ənsimli                        	 ənsimli                       
serviceable                    	 sərvəsəbəl                     	 sərvəsəbəl                    
connived                       	 connived*                      	 kənaɪvd                       
portables                      	 pɔrtəbəlz                      	 pɔrtəbəlz                     
flipped                        	 flɪpt                          	 flɪpt                         
stowaway                       	 stoʊəwe                        	 stoʊəwe                       
thoughtfully                   	 θɔtfəli                        	 θɔtfəli                       
onlooker                       	 ɔnlʊkər                        	 ɔnlʊkər                       
apologetic                     	 əpɑləʤɛtɪk                     	 əpɑləʤɛtɪk                    
visualizations                 	 visualizations*                	 vɪʒəwəlzeʃənz                 
telecasts                      	 tɛləkæsts                      	 tɛləkæsts                     
or                             	 ər                             	 ər                            
validates                      	 vælədets                       	 vælədets                      
bocage                         	 bocage*                        	 boʊkɪʤ                        
elegant                        	 ɛləgənt                        	 ɛləgənt                       
sphere                         	 sfɪr                           	 sfɪr                          
dobie                          	 dɑbi                           	 doʊbi                         
coachman                       	 koʊʧmən                        	 koʊʧmən                       
rix                            	 rɪks                           	 rɪks                          
alcove                         	 ælkoʊv                         	 ælkoʊv                        
transgendered                  	 transgendered*                 	 trænzgɛndərd                  
additives                      	 ædɪtɪvz                        	 ædɪtɪvz                       
magots                         	 magots*                        	 mægəts                        
lazy                           	 lezi                           	 lezi                          
mainmast                       	 mainmast*                      	 menmæst                       
atalanta                       	 ætəlæntə                       	 ætəlæntə                      
boutonniere                    	 boutonniere*                   	 butənir                       
frames                         	 fremz                          	 fremz                         
indexed                        	 ɪndɛkst                        	 ɪndɛkst                       
pino                           	 pinoʊ                          	 paɪnoʊ                        
duration                       	 dʊreʃən                        	 dʊreʃən                       
misjudging                     	 mɪsʤəʤɪŋ                       	 mɪsʤəʤɪŋ                      
shamans                        	 ʃemənz                         	 ʃemənz                        
bonding                        	 bɑndɪŋ                         	 bɑndɪŋ                        
presses                        	 prɛsɪz                         	 prɛsɪz                        
entry                          	 ɛntri                          	 ɛntri                         
rsum                           	 rsum*                          	 rəm                           
housebroken                    	 haʊsbroʊkən                    	 haʊsbroʊkən                   
solid                          	 sɑləd                          	 sɑləd                         
hurtle                         	 hərtəl                         	 hərtəl                        
hydrosulfide                   	 haɪdroʊsəlfaɪd                 	 haɪdroʊsəlfaɪd                
bequeathed                     	 bəkwiθt                        	 bəkwiθt                       
publisher                      	 pəblɪʃər                       	 pəblɪʃər                      
outgeneraled                   	 outgeneraled*                  	 aʊtgɛnərəld                   
liza                           	 lizə                           	 lizə                          
connex                         	 connex*                        	 kɑnɛks                        
gaulish                        	 gaulish*                       	 gɔlɪʃ                         
benefactresses                 	 benefactresses*                	 bɛnəfæktrəsɪz                 
ignore                         	 ɪgnɔr                          	 ɪgnɔr                         
simpletons                     	 simpletons*                    	 sɪmpəltənz                    
max                            	 mæks                           	 mæks                          
replowing                      	 replowing*                     	 riploʊɪŋ                      
engaging                       	 ɪngeʤɪŋ                        	 ɪngeʤɪŋ                       
configurations                 	 kənfɪgjəreʃənz                 	 kənfɪgjəreʃənz                
vinegars                       	 vɪnɪgərz                       	 vɪnɪgərz                      
finns                          	 fɪnz                           	 fɪnz                          
damn                           	 dæm                            	 dæm                           
privata                        	 privata*                       	 praɪvətə                      
diabolic                       	 diabolic*                      	 daɪəbɑlɪk                     
capitulated                    	 kəpɪʧəletɪd                    	 kəpɪʧəletɪd                   
balancer                       	 bælənsər                       	 bælənsər                      
dod                            	 dod*                           	 dɑd                           
sikes                          	 saɪks                          	 saɪks                         
forbar                         	 forbar*                        	 fɔrbɑr                        
bloomed                        	 blumd                          	 blumd                         
refile                         	 rifaɪl                         	 rifaɪl                        
unc                            	 unc*                           	 ənk                           
caymans                        	 kemənz                         	 kemənz                        
injudicial                     	 injudicial*                    	 ɪnʤədɪʃəl                     
telethons                      	 telethons*                     	 tɛləθɑnz                      
vendable                       	 vendable*                      	 vɛndəbəl                      
nerve                          	 nərv                           	 nərv                          
manoeuvrings                   	 manoeuvrings*                  	 mənuvərɪŋz                    
anaesthesiology                	 ænəsθiziɑləʤi                  	 ænɪsθiʒiɑləʤi                 
guns                           	 gənz                           	 gənz                          
dominica                       	 dəmɪnɪkə                       	 doʊmɪnɪkə                     
freeloading                    	 freeloading*                   	 friloʊdɪŋ                     
sealant                        	 silənt                         	 silənt                        
exorcism                       	 ɛksərsɪzəm                     	 ɛksərsɪzəm                    
aura                           	 ɔrə                            	 ɔrə                           
gargoyle                       	 gɑrgɔɪl                        	 gɑrgɔɪl                       
aquatics                       	 aquatics*                      	 ækwətɪks                      
elitism                        	 ɛlɪtɪzəm                       	 ɛlɪtɪzəm                      
wrongful                       	 rɔŋfəl                         	 rɔŋfəl                        
drowns                         	 draʊnz                         	 draʊnz                        
rafters                        	 ræftərz                        	 ræftərz                       
functioning                    	 fəŋkʃənɪŋ                      	 fəŋkʃənɪŋ                     
weight                         	 wet                            	 wet                           
beanstalk                      	 beanstalk*                     	 binstɔk                       
amok                           	 əmək                           	 əmək                          
bonking                        	 bonking*                       	 bɑŋkɪŋ                        
scaphoid                       	 scaphoid*                      	 skæfɔɪd                       
pistol                         	 pɪstəl                         	 pɪstəl                        
prioritize                     	 praɪɔrətaɪz                    	 praɪɔrətaɪz                   
neap                           	 neap*                          	 nip                           
okolehao                       	 okolehao*                      	 oʊkəlhe                       
coveys                         	 coveys*                        	 kəviz                         
popovers                       	 popovers*                      	 pəpoʊvərz                     
delphine                       	 dɛlfini                        	 dɪlfaɪn                       
griffon                        	 grɪfən                         	 grɪfɑn                        
vagary                         	 vegəri                         	 vægəri                        
everywhere                     	 ɛvriwɛr                        	 ɛvriwɛr                       
crunch                         	 krənʧ                          	 krənʧ                         
stilled                        	 stɪld                          	 stɪld                         
fille                          	 fille*                         	 fɪl                           
viceregal                      	 viceregal*                     	 vɪsrɪgəl                      
superset                       	 superset*                      	 supərsɛt                      
downer                         	 daʊnər                         	 daʊnər                        
plasticity                     	 plasticity*                    	 plæstɪsəti                    
previously                     	 priviəsli                      	 priviəsli                     
buffo                          	 bufoʊ                          	 bəfoʊ                         
survivability                  	 sərvaɪvəbɪlɪti                 	 sərvaɪvəbɪlɪti                
atraumatic                     	 atraumatic*                    	 ætrɔmætɪk                     
guidance                       	 gaɪdəns                        	 gaɪdəns                       
unreal                         	 ənril                          	 ənril                         
freshly                        	 frɛʃli                         	 frɛʃli                        
annexing                       	 ənɛksɪŋ                        	 ænɛksɪŋ                       
wonton                         	 wonton*                        	 wəntən                        
cuing                          	 kjuɪŋ                          	 kwɪŋ                          
scintillate                    	 scintillate*                   	 sɪntəlet                      
sandbars                       	 sandbars*                      	 sændbɑrz                      
kreutzer                       	 kreutzer*                      	 krutsər                       
inventors                      	 ɪnvɛntərz                      	 ɪnvɛntərz                     
autographed                    	 ɔtəgræft                       	 ɔtəgræft                      
linch                          	 lɪnʧ                           	 lɪnʧ                          
combinate                      	 combinate*                     	 kɑmbənet                      
gluconate                      	 gluconate*                     	 glukənet                      
gibbons                        	 gɪbɪnz                         	 gɪbɪnz                        
molt                           	 moʊlt                          	 moʊlt                         
macs                           	 mæks                           	 mæks                          
sayings                        	 seɪŋz                          	 seɪŋz                         
aramaic                        	 aramaic*                       	 əræmɪk                        
rotenone                       	 rotenone*                      	 roʊtənoʊn                     
stockmen                       	 stockmen*                      	 stɑkmɪn                       
plowed                         	 plaʊd                          	 ploʊd                         
smeared                        	 smɪrd                          	 smɪrd                         
herp                           	 herp*                          	 hərp                          
capitan                        	 kæpɪtən                        	 kæpɪtən                       
overprotect                    	 oʊvərprətɛkt                   	 oʊvərproʊtɛkt                 
intoxicates                    	 ɪntɑksəkets                    	 ɪntɑksəkets                   
detail                         	 ditel                          	 ditel                         
noonish                        	 noonish*                       	 nunɪʃ                         
mead                           	 mid                            	 mid                           
spice                          	 spaɪs                          	 spaɪs                         
hug                            	 həg                            	 həg                           
convertibles                   	 kənvərtəbəlz                   	 kənvərtəbəlz                  
beading                        	 beading*                       	 bidɪŋ                         
processed                      	 prɑsɛst                        	 prɑsɛst                       
ephialtes                      	 ephialtes*                     	 ɛfiəltiz                      
compressing                    	 kəmprɛsɪŋ                      	 kəmprɛsɪŋ                     
intercuts                      	 intercuts*                     	 ɪntərkəts                     
sighted                        	 saɪtɪd                         	 saɪtɪd                        
doornail                       	 dɔrnel                         	 dɔrnel                        
havent                         	 havent*                        	 hævənt                        
enlists                        	 ɛnlɪsts                        	 ɛnlɪsts                       
mudra                          	 mədrə                          	 mjudrə                        
prescribing                    	 priskraɪbɪŋ                    	 priskraɪbɪŋ                   
showered                       	 ʃaʊərd                         	 ʃaʊərd                        
rammed                         	 ræmd                           	 ræmd                          
prof                           	 prof*                          	 prɔf                          
reads                          	 ridz                           	 ridz                          
hysterically                   	 hɪstɛrɪkli                     	 hɪstɛrɪkli                    
necromancer                    	 nɛkrəmænsər                    	 nɛkrəmænsər                   
loony                          	 luni                           	 luni                          
benet                          	 bɛnət                          	 bɛnət                         
stylographic                   	 stylographic*                  	 staɪləgræfɪk                  
creators                       	 krietərz                       	 krietərz                      
tattooer                       	 tattooer*                      	 tætuər                        
shrub                          	 ʃrəb                           	 ʃrəb                          
rozzers                        	 rozzers*                       	 rɑzərz                        
dinked                         	 dinked*                        	 dɪŋkt                         
bloodworm                      	 bloodworm*                     	 blədwərm                      
aperitifs                      	 aperitifs*                     	 əpɛrətifs                     
flair                          	 flɛr                           	 flɛr                          
youd                           	 youd*                          	 jʊd                           
metres                         	 mitərz                         	 mitərz                        
mantra                         	 mæntrə                         	 mæntrə                        
unconvincing                   	 ənkənvɪnsɪŋ                    	 ənkənvɪnsɪŋ                   
automaton                      	 ɔtɑmətɑn                       	 ɔtəmetən                      
conserves                      	 conserves*                     	 kənsərvz                      
swell                          	 swɛl                           	 swɛl                          
disapproval                    	 dɪsəpruvəl                     	 dɪsəpruvəl                    
cobbling                       	 cobbling*                      	 kɑbəlɪŋ                       
pairs                          	 pɛrz                           	 pɛrz                          
propriety                      	 prəpraɪəti                     	 prəpraɪəti                    
dumas                          	 dumɑ                           	 duməz                         
whirlpool                      	 wərlpul                        	 wərlpul                       
sideway                        	 sideway*                       	 saɪdwe                        
stagey                         	 stagey*                        	 steʤi                         
quoad                          	 quoad*                         	 kwoʊd                         
lads                           	 lædz                           	 lædz                          
frigate                        	 frɪgət                         	 frɪgət                        
pixilated                      	 pixilated*                     	 pɪksəletɪd                    
advisees                       	 advisees*                      	 ædvaɪziz                      
knowable                       	 knowable*                      	 noʊəbəl                       
faithfully                     	 feθfəli                        	 feθfəli                       
refire                         	 refire*                        	 rifaɪər                       
allocated                      	 æləketɪd                       	 æləketɪd                      
easeful                        	 easeful*                       	 izfəl                         
wanders                        	 wɑndərz                        	 wɑndərz                       
lalo                           	 lalo*                          	 leloʊ                         
volunteered                    	 vɑləntɪrd                      	 vɑləntɪrd                     
hoops                          	 hups                           	 hups                          
affa                           	 affa*                          	 æfə                           
writhing                       	 rɪθɪŋ                          	 rɪθɪŋ                         
breck                          	 brɛk                           	 brɛk                          
gambia                         	 gæmbiə                         	 gæmbiə                        
prowesses                      	 prowesses*                     	 praʊəsɪz                      
brigand                        	 brigand*                       	 brɪgənd                       
firelight                      	 firelight*                     	 faɪrlaɪt                      
practitioner                   	 præktɪʃənər                    	 præktɪʃənər                   
stunted                        	 stəntɪd                        	 stəntɪd                       
thumbtack                      	 thumbtack*                     	 θəmtæk                        
decorating                     	 dɛkəretɪŋ                      	 dɛkəretɪŋ                     
agos                           	 agos*                          	 əgɑs                          
speculative                    	 spɛkjələtɪv                    	 spɛkjələtɪv                   
teacups                        	 teacups*                       	 tikəps                        
magnetise                      	 magnetise*                     	 mægnətaɪz                     
polysyllabic                   	 pɑlisɪlæbɪk                    	 pɑlisɪlæbɪk                   
gutless                        	 gətlɛs                         	 gətlɛs                        
chevrolet                      	 ʃɛvroʊle                       	 ʃɛvrəlɛt                      
convocations                   	 convocations*                  	 kɑnvəkeʃənz                   
advertisers                    	 ædvərtaɪzərz                   	 ædvərtaɪzərz                  
crispin                        	 krɪspɪn                        	 krɪspɪn                       
raffling                       	 raffling*                      	 ræfəlɪŋ                       
dolling                        	 dolling*                       	 dɑlɪŋ                         
parody                         	 pɛrədi                         	 pɛrədi                        
earth                          	 ərθ                            	 ərθ                           
privatization                  	 praɪvətəzeʃən                  	 praɪvətɪzeʃən                 
reawaken                       	 riəwekən                       	 riəwekən                      
mutuality                      	 mjuʧuælɪti                     	 mjuʧuælɪti                    
unrecognized                   	 ənrɛkəgnaɪzd                   	 ənrɛkəgnaɪzd                  
revelling                      	 revelling*                     	 rɛvəlɪŋ                       
intertwine                     	 ɪntərtwaɪn                     	 ɪntərtwaɪn                    
chorography                    	 chorography*                   	 kərɑgrəfi                     
rectitude                      	 rɛktɪtud                       	 rɛktɪtud                      
myrmidon                       	 mərmɪdɪn                       	 mɪrmɪdən                      
colonial                       	 kəloʊniəl                      	 kəloʊniəl                     
alighted                       	 alighted*                      	 əlaɪtɪd                       
vile                           	 vaɪl                           	 vaɪl                          
garrotte                       	 garrotte*                      	 gɛrət                         
flimsiest                      	 flɪmziəst                      	 flɪmziəst                     
unsung                         	 ənsəŋ                          	 ənsəŋ                         
peele                          	 pil                            	 pil                           
entangle                       	 ɛntæŋgəl                       	 ɛntæŋgəl                      
miscalculated                  	 mɪskælkjəletɪd                 	 mɪskælkjəletɪd                
registers                      	 rɛʤɪstərz                      	 rɛʤɪstərz                     
vesiculitis                    	 vesiculitis*                   	 vɛzəkjulɪtɪs                  
leathers                       	 lɛðərz                         	 lɛðərz                        
trumpeter                      	 trəmpətər                      	 trəmpətər                     
overlying                      	 oʊvərlaɪɪŋ                     	 oʊvərlaɪɪŋ                    
barefooted                     	 barefooted*                    	 bɛrfʊtɪd                      
sociopathy                     	 sociopathy*                    	 soʊsiəpæθi                    
debbies                        	 debbies*                       	 dɛbiz                         
seems                          	 simz                           	 simz                          
rearmed                        	 rearmed*                       	 riɑrmd                        
slacking                       	 slacking*                      	 slækɪŋ                        
hackles                        	 hækəlz                         	 hækəlz                        
unending                       	 ənɛndɪŋ                        	 ənɛndɪŋ                       
querido                        	 querido*                       	 kwɪraɪdoʊ                     
liabilities                    	 laɪəbɪlɪtiz                    	 laɪəbɪlɪtiz                   
biorhythm                      	 biorhythm*                     	 baɪərhaɪtm                    
tourist                        	 tʊrɪst                         	 tʊrɪst                        
spurting                       	 spərtɪŋ                        	 spərtɪŋ                       
valance                        	 valance*                       	 væləns                        
scented                        	 sɛntɪd                         	 sɛntɪd                        
hose                           	 hoʊz                           	 hoʊz                          
dreamed                        	 drimd                          	 drimd                         
pitied                         	 pɪtid                          	 pɪtid                         
mestizo                        	 mɛstizoʊ                       	 mɛstizoʊ                      
khedive                        	 khedive*                       	 kidaɪv                        
snup                           	 snup*                          	 snəp                          
hydrodynamics                  	 hydrodynamics*                 	 haɪdroʊdaɪnæmɪks              
morris                         	 mɔrɪs                          	 mɔrəs                         
millers                        	 mɪlərz                         	 mɪlərz                        
blobby                         	 blɑbi                          	 blɑbi                         
ungroomed                      	 ungroomed*                     	 əngrumd                       
newfoundlander                 	 newfoundlander*                	 nufaʊndər                     
intrude                        	 ɪntrud                         	 ɪntrud                        
emotions                       	 ɪmoʊʃənz                       	 ɪmoʊʃənz                      
tawdry                         	 tɔdri                          	 tɔdri                         
barmen                         	 barmen*                        	 bɑrmən                        
expectation                    	 ɛkspɛkteʃən                    	 ɛkspɛkteʃən                   
roundabouts                    	 roundabouts*                   	 raʊndəbaʊts                   
oozed                          	 uzd                            	 uzd                           
ageism                         	 ageism*                        	 eʤɪzəm                        
unintelligibly                 	 unintelligibly*                	 ənɪntɛləʤəbli                 
phospholipid                   	 phospholipid*                  	 fɑsfəlɪpt                     
bulldoze                       	 bʊldoʊz                        	 bʊldoʊz                       
jameson                        	 ʤemsən                         	 ʤemsən                        
sinusitis                      	 sinusitis*                     	 sɪnəsɪtɪs                     
cid                            	 sɪd                            	 sɪd                           
trending                       	 trɛndɪŋ                        	 trɛndɪŋ                       
randomized                     	 rændəmaɪzd                     	 rændəmaɪzd                    
regear                         	 regear*                        	 rɪʤər                         
shuttered                      	 ʃətərd                         	 ʃətərd                        
femme                          	 fɛm                            	 fɛm                           
art                            	 ɑrt                            	 ɑrt                           
hyphen                         	 haɪfən                         	 haɪfən                        
linder                         	 lɪndər                         	 lɪndər                        
understand                     	 əndərstænd                     	 əndərstænd                    
freshet                        	 freshet*                       	 frɛʃət                        
mac                            	 mæk                            	 mæk                           
thorough                       	 θəroʊ                          	 θəroʊ                         
scrubs                         	 scrubs*                        	 skrəbz                        
cuddle                         	 kədəl                          	 kədəl                         
enactments                     	 ɛnæktmənts                     	 ɛnæktmənts                    
ballplayers                    	 bɔlpleərz                      	 bælpleərz                     
disguising                     	 dɪsgaɪzɪŋ                      	 dɪsgaɪzɪŋ                     
magisterially                  	 magisterially*                 	 mæʤɪstiriəli                  
dopa                           	 doʊpə                          	 doʊpə                         
fibula                         	 fɪbjələ                        	 fɪbjələ                       
wisecracking                   	 waɪzkrækɪŋ                     	 waɪzkrækɪŋ                    
optionals                      	 optionals*                     	 ɔpʃənəlz                      
funding                        	 fəndɪŋ                         	 fəndɪŋ                        
ailerons                       	 elərɑnz                        	 elərɑnz                       
pension                        	 pɛnʃən                         	 pɛnʃən                        
oc                             	 oc*                            	 ɑk                            
messaging                      	 mɛsɪʤɪŋ                        	 mɛsəʤɪŋ                       
souvenir                       	 suvənɪr                        	 suvənɪr                       
punning                        	 punning*                       	 pənɪŋ                         
chauffeured                    	 ʃoʊfərd                        	 ʃoʊfərd                       
crossbow                       	 krɔsboʊ                        	 krɔsboʊ                       
dingoes                        	 dingoes*                       	 dɪŋgoʊz                       
augur                          	 ɔgər                           	 ɔgər                          
shtick                         	 ʃtɪk                           	 ʃɪk                           
beginner                       	 bɪgɪnər                        	 bɪgɪnər                       
fatiguing                      	 fətigɪŋ                        	 fətigɪŋ                       
counters                       	 kaʊntərz                       	 kaʊntərz                      
remarkable                     	 rɪmɑrkəbəl                     	 rɪmɑrkəbəl                    
psychological                  	 saɪkəlɑʤɪkəl                   	 saɪkəlɑʤɪkəl                  
bing                           	 bɪŋ                            	 bɪŋ                           
penile                         	 pinaɪl                         	 pinaɪl                        
glyceryl                       	 glyceryl*                      	 glɪsərl                       
redneck                        	 rɛdnɛk                         	 rɛdnɛk                        
confronts                      	 kənfrənts                      	 kənfrənts                     
tenets                         	 tɛnəts                         	 tɛnəts                        
physiologic                    	 physiologic*                   	 fɪziɑləʤɪk                    
frosted                        	 frɔstɪd                        	 frɔstɪd                       
taupe                          	 taupe*                         	 tɔp                           
welds                          	 wɛldz                          	 wɛldz                         
dn                             	 dn*                            	 dɑn                           
snicket                        	 snicket*                       	 snɪkɪt                        
dwarfism                       	 dwɔrfɪzəm                      	 dwɔrfɪzəm                     
reverify                       	 reverify*                      	 rɛvərɪfaɪ                     
guly                           	 guly*                          	 gulaɪ                         
lawsuit                        	 lɔsut                          	 lɔsut                         
socking                        	 sɑkɪŋ                          	 sɑkɪŋ                         
imperium                       	 imperium*                      	 ɪmpɪriəm                      
woops                          	 woops*                         	 wups                          
pill                           	 pɪl                            	 pɪl                           
baselines                      	 beslaɪnz                       	 beslaɪnz                      
purposefulness                 	 purposefulness*                	 pərpəsfəlnəs                  
eightball                      	 eightball*                     	 etbɔl                         
pussy                          	 pʊsi                           	 pʊsi                          
lila                           	 lilə                           	 lilə                          
salivating                     	 sæləvetɪŋ                      	 sæləvetɪŋ                     
treeless                       	 triləs                         	 triləs                        
cretaceous                     	 krɪteʃɪs                       	 krɪteʃɪs                      
cleanses                       	 cleanses*                      	 klɛnzɪz                       
trophies                       	 troʊfiz                        	 troʊfiz                       
but                            	 bət                            	 bət                           
dabba                          	 dabba*                         	 dɑbə                          
downstage                      	 daʊnsteʤ                       	 daʊnsteʤ                      
collagenase                    	 collagenase*                   	 kɑləgənes                     
nighthawks                     	 naɪthɔks                       	 naɪthɔks                      
hyphenates                     	 haɪfənets                      	 haɪfənets                     
unethically                    	 ənɛθɪkli                       	 ənɛθɪkli                      
heater                         	 hitər                          	 hitər                         
kedgeree                       	 kedgeree*                      	 kɛʤəri                        
supposing                      	 səpoʊzɪŋ                       	 səpoʊzɪŋ                      
classist                       	 classist*                      	 klæsɪst                       
hellholes                      	 hellholes*                     	 hɛlhoʊlz                      
moline                         	 moʊlin                         	 məlaɪn                        
bonnets                        	 bonnets*                       	 bɑnəts                        
firefights                     	 faɪrfaɪts                      	 faɪrfaɪts                     
carousel                       	 kɛrəsɛl                        	 kɛrəsɛl                       
contestant                     	 kəntɛstənt                     	 kəntɛstənt                    
draped                         	 drept                          	 drept                         
flagrante                      	 flagrante*                     	 flegrənt                      
crucible                       	 krusəbəl                       	 krusəbəl                      
podcast                        	 pɔdkæst                        	 pɑdkæst                       
mucosal                        	 mjukoʊsəl                      	 mjukoʊsəl                     
award                          	 əwɔrd                          	 əwɔrd                         
dimmers                        	 dɪmərz                         	 dɪmərz                        
godparents                     	 godparents*                    	 gɑdpɛrənts                    
oclock                         	 oclock*                        	 ɑklɑk                         
george                         	 ʤɔrʤ                           	 ʤɔrʤ                          
couldn                         	 couldn*                        	 koʊldn                        
insects                        	 ɪnsɛkts                        	 ɪnsɛkts                       
publications                   	 pəblɪkeʃənz                    	 pəblɪkeʃənz                   
pashas                         	 pashas*                        	 pæʃəz                         
thickened                      	 θɪkənd                         	 θɪkənd                        
bonging                        	 bonging*                       	 bɑŋɪŋ                         
cheshire                       	 ʧɛʃər                          	 ʧɛʃər                         
temptations                    	 tɛmteʃənz                      	 tɛmteʃənz                     
excalibur                      	 ɛkskæləbər                     	 ɪkskæləbər                    
reports                        	 rɪpɔrts                        	 rɪpɔrts                       
mistakenly                     	 mɪstekənli                     	 mɪstekənli                    
betrayer                       	 betrayer*                      	 bɪtreər                       
programs                       	 proʊgræmz                      	 proʊgræmz                     
rhinitis                       	 rhinitis*                      	 rənɪtɪs                       
mockingbird                    	 mɑkɪŋbərd                      	 mɑkɪŋbərd                     
bipeds                         	 bipeds*                        	 baɪps                         
vague                          	 veg                            	 veg                           
jape                           	 jape*                          	 ʤep                           
unfired                        	 unfired*                       	 ənfaɪərd                      
jeanne                         	 ʤin                            	 ʤin                           
glockenspiels                  	 glockenspiels*                 	 glɑkənspilz                   
gerkin                         	 ʤərkɪn                         	 ʤərkɪn                        
luring                         	 lʊrɪŋ                          	 lʊrɪŋ                         
moot                           	 mut                            	 mut                           
moocher                        	 moocher*                       	 muʧər                         
unhygienic                     	 unhygienic*                    	 ənhaɪgɛnɪk                    
blackboards                    	 blækbɔrdz                      	 blækbɔrdz                     
dramatizing                    	 dræmətaɪzɪŋ                    	 drəmetɪzɪŋ                    
sophocles                      	 sɑfəkliz                       	 səfoʊkəlz                     
granny                         	 græni                          	 græni                         
crois                          	 crois*                         	 krɔɪz                         
dialers                        	 dialers*                       	 daɪələrz                      
sitters                        	 sɪtərz                         	 sɪtərz                        
prosecute                      	 prɑsəkjut                      	 prɑsəkjut                     
dogs                           	 dɔgz                           	 dɔgz                          
whereas                        	 wɛræz                          	 wɛræz                         
transformational               	 trænsfərmeʃənəl                	 trænsfərmeʃənəl               
inhaled                        	 ɪnheld                         	 ɪnheld                        
emptiest                       	 emptiest*                      	 ɛmtiəst                       
fueling                        	 fjulɪŋ                         	 fjuɪŋ                         
culpa                          	 kəlpə                          	 kəlpə                         
tintypes                       	 tintypes*                      	 tɪntaɪps                      
whirring                       	 wərɪŋ                          	 wərɪŋ                         
mushrooming                    	 məʃrʊmɪŋ                       	 məʃrumɪŋ                      
herba                          	 herba*                         	 ərbə                          
blowy                          	 bloʊi                          	 bloʊi                         
italian                        	 ɪtæljən                        	 ɪtæljən                       
sunna                          	 sunna*                         	 sənə                          
cool                           	 kul                            	 kul                           
ragtags                        	 ragtags*                       	 rægtægz                       
venezuela                      	 vɛnɪzwelə                      	 vɛnəzuələ                     
fledging                       	 flɛʤɪŋ                         	 flɛʤɪŋ                        
angiogram                      	 ænʤioʊgræm                     	 ænʤiəgræm                     
checkpoint                     	 ʧɛkpɔɪnt                       	 ʧɛkpɔɪnt                      
fibers                         	 faɪbərz                        	 faɪbərz                       
hula                           	 hulə                           	 hjulə                         
consul                         	 kɑnsəl                         	 kɑnsəl                        
scamps                         	 scamps*                        	 skæmps                        
honorary                       	 ɑnərɛri                        	 ɑnərɛri                       
redraft                        	 ridræft                        	 ridræft                       
sewage                         	 suɪʤ                           	 suɪʤ                          
aspca                          	 aspca*                         	 æspə                          
lehua                          	 lehua*                         	 lihə                          
hobbling                       	 hɑbəlɪŋ                        	 hɑbəlɪŋ                       
empanada                       	 empanada*                      	 ɛmpənɑdə                      
stubble                        	 stəbəl                         	 stəbəl                        
motorcycle                     	 moʊtərsaɪkəl                   	 moʊtərsaɪkəl                  
roughhousing                   	 roughhousing*                  	 rəfhaʊzɪŋ                     
detonate                       	 dɛtənet                        	 dɛtənet                       
podiatrist                     	 pədaɪətrɪst                    	 pədietrəst                    
hipsters                       	 hɪpstərz                       	 hɪpstərz                      
liquefies                      	 liquefies*                     	 lɪkwəfaɪz                     
tulare                         	 tulare*                        	 tulər                         
bowker                         	 boʊkər                         	 boʊkər                        
streng                         	 strɛŋ                          	 strɛŋ                         
resemble                       	 rɪzɛmbəl                       	 rɪzɛmbəl                      
inexplicable                   	 ɪnəksplɪkəbəl                  	 ɪnəksplɪkəbəl                 
aha                            	 ɑhɑ                            	 ɑhɑ                           
ungainly                       	 əngenli                        	 əngenli                       
crewed                         	 crewed*                        	 krud                          
doggle                         	 doggle*                        	 dɑgəl                         
scumbag                        	 skəmbæg                        	 skəmbæg                       
shavings                       	 ʃevɪŋz                         	 ʃevɪŋz                        
stubbornest                    	 stubbornest*                   	 stəbərnəst                    
peking                         	 pikɪŋ                          	 pikɪŋ                         
solemnify                      	 solemnify*                     	 səlɛmnəfaɪ                    
tup                            	 tup*                           	 təp                           
whitecoat                      	 whitecoat*                     	 waɪtkoʊt                      
shark                          	 ʃɑrk                           	 ʃɑrk                          
camshaft                       	 kæmʃæft                        	 kæmʃæft                       
imperative                     	 ɪmpɛrətɪv                      	 ɪmpɛrətɪv                     
wingmen                        	 wingmen*                       	 wɪŋmɪn                        
fritters                       	 fritters*                      	 frɪtərz                       
gaby                           	 gæbi                           	 gebi                          
tourists                       	 tʊrɪsts                        	 tʊrɪsts                       
sinfully                       	 sinfully*                      	 sɪnfəli                       
receptionist                   	 rɪsɛpʃənɪst                    	 rɪsɛpʃənɪst                   
earner                         	 ərnər                          	 ərnər                         
earphones                      	 ɪrfoʊnz                        	 ɪrfoʊnz                       
shipmate                       	 ʃɪpmet                         	 ʃɪpmet                        
mooching                       	 mooching*                      	 muʧɪŋ                         
daddies                        	 dædiz                          	 dædiz                         
relations                      	 rileʃənz                       	 rileʃənz                      
sensibilities                  	 sɛnsɪbɪlɪtiz                   	 sɛnsɪbɪlɪtiz                  
bellybuttons                   	 bellybuttons*                  	 bəlibətənz                    
straits                        	 strets                         	 strets                        
lurk                           	 lərk                           	 lərk                          
sider                          	 saɪdər                         	 saɪdər                        
privileges                     	 prɪvɪlɪʤɪz                     	 prɪvɪlɪʤɪz                    
lector                         	 lɛktər                         	 lɛktər                        
grotesque                      	 groʊtɛsk                       	 groʊtɛsk                      
unsurpassed                    	 ənsərpæst                      	 ənsərpæst                     
tiptoes                        	 tiptoes*                       	 tɪptoʊz                       
unthrilled                     	 unthrilled*                    	 ənθrɪld                       
reticulum                      	 reticulum*                     	 ritɪkjələm                    
born                           	 bɔrn                           	 bɔrn                          
expropriated                   	 ɛksproʊprietɪd                 	 ɛksproʊprietɪd                
soubrette                      	 soubrette*                     	 səbrɛt                        
sentimentalize                 	 sentimentalize*                	 sɛntəmɛnəlz                   
nips                           	 nɪps                           	 nɪps                          
hyperventilating               	 hyperventilating*              	 haɪpərvɛntɪletɪŋ              
brutalizes                     	 brutəlaɪzɪz                    	 brutælaɪzɪz                   
elicits                        	 ɪlɪsəts                        	 ɪlɪsəts                       
splutters                      	 splutters*                     	 splətərz                      
peddled                        	 pɛdəld                         	 pɛdəld                        
derived                        	 dəraɪvd                        	 dəraɪvd                       
arouses                        	 əraʊzɪz                        	 əraʊzɪz                       
surreys                        	 surreys*                       	 səriz                         
user                           	 juzər                          	 juzər                         
astrakhan                      	 æstrəkɑn                       	 æstrekən                      
cased                          	 cased*                         	 kest                          
invalids                       	 ɪnvələdz                       	 ɪnvələdz                      
lavaliers                      	 lavaliers*                     	 lævəlɪrz                      
hobnailed                      	 hobnailed*                     	 hɑbneld                       
quirks                         	 kwərks                         	 kwərks                        
bridgehead                     	 brɪʤhɛd                        	 brɪʤhɛd                       
qualified                      	 kwɑləfaɪd                      	 kwɑləfaɪd                     
marks                          	 mɑrks                          	 mɑrks                         
authenticity                   	 ɔθəntɪsɪti                     	 ɔθəntɪsɪti                    
delaying                       	 dɪleɪŋ                         	 dɪleɪŋ                        
floated                        	 floʊtɪd                        	 floʊtɪd                       
smokers                        	 smoʊkərz                       	 smoʊkərz                      
plant                          	 plænt                          	 plænt                         
friendship                     	 frɛndʃɪp                       	 frɛndʃɪp                      
burros                         	 bəroʊz                         	 bəroʊz                        
conduction                     	 kəndəkʃən                      	 kəndəkʃən                     
inflate                        	 ɪnflet                         	 ɪnflet                        
emeril                         	 emeril*                        	 ɛmərəl                        
angulation                     	 angulation*                    	 æŋgjəleʃən                    
dig                            	 dɪg                            	 dɪg                           
embezzlers                     	 ɪmbɛzələrz                     	 ɪmbɛzələrz                    
spyware                        	 spaɪwɛr                        	 spaɪwɛr                       
shenanigans                    	 ʃənænɪgənz                     	 ʃɛnənəgənz                    
isis                           	 aɪsəs                          	 aɪzɪs                         
ironworkers                    	 ironworkers*                   	 aɪrənwərkərz                  
selden                         	 sɛldən                         	 sɛldən                        
quackster                      	 quackster*                     	 kwækstər                      
creepers                       	 creepers*                      	 kripərz                       
fidelis                        	 fidelis*                       	 faɪdɛləs                      
hale                           	 hel                            	 hel                           
skelly                         	 skɛli                          	 skɛli                         
adored                         	 ədɔrd                          	 ədɔrd                         
ew                             	 ew*                            	 ju                            
expediently                    	 expediently*                   	 ɪkspidiəntli                  
electrical                     	 ɪlɛktrɪkəl                     	 ɪlɛktrɪkəl                    
backrooms                      	 bækrumz                        	 bækrumz                       
parachuting                    	 pɛrəʃutɪŋ                      	 pɛrəʃutɪŋ                     
ditches                        	 dɪʧɪz                          	 dɪʧɪz                         
handstands                     	 hændstændz                     	 hændstændz                    
voyeur                         	 vɔɪjur                         	 vɔɪjur                        
plus                           	 pləs                           	 pləs                          
amebic                         	 amebic*                        	 əmɛbɪk                        
scowling                       	 skaʊlɪŋ                        	 skaʊlɪŋ                       
twitted                        	 twitted*                       	 twɪtɪd                        
asker                          	 æskər                          	 æskər                         
claimants                      	 klemənts                       	 klemənts                      
goaltending                    	 goaltending*                   	 goʊltɛndɪŋ                    
retaliates                     	 retaliates*                    	 rɪtæliets                     
scruffy                        	 skrəfi                         	 skrəfi                        
correctly                      	 kərɛktli                       	 kərɛktli                      
tushy                          	 tushy*                         	 təʃi                          
recommended                    	 rɛkəmɛndɪd                     	 rɛkəmɛndɪd                    
trailer                        	 trelər                         	 trelər                        
kobi                           	 kobi*                          	 koʊbi                         
wildcatters                    	 waɪldkætərz                    	 waɪldkætərz                   
misjudge                       	 mɪsʤəʤ                         	 mɪsʤəʤ                        
heathens                       	 heathens*                      	 hɛðənz                        
unsay                          	 unsay*                         	 ənse                          
cultivating                    	 kəltɪvetɪŋ                     	 kəltɪvetɪŋ                    
handbags                       	 hændbægz                       	 hændbægz                      
arised                         	 arised*                        	 əraɪzd                        
dermatologist                  	 dərmətɑləʤɪst                  	 dərmətɑləʤɪst                 
octonal                        	 octonal*                       	 ɑktənəl                       
faltering                      	 fɔltərɪŋ                       	 fɑltərɪŋ                      
constructed                    	 kənstrəktɪd                    	 kənstrəktɪd                   
specks                         	 spɛks                          	 spɛks                         
chieftains                     	 ʧiftənz                        	 ʧiftənz                       
stale                          	 stel                           	 stel                          
maine                          	 men                            	 men                           
braid                          	 bred                           	 bred                          
balsams                        	 balsams*                       	 bɔlsəmz                       
brutalized                     	 brutəlaɪzd                     	 brutælaɪzd                    
altruist                       	 altruist*                      	 ɔltruɪst                      
unrestrained                   	 ənristrend                     	 ənristrend                    
levitating                     	 lɛvətetɪŋ                      	 lɛvətetɪŋ                     
reaching                       	 riʧɪŋ                          	 riʧɪŋ                         
irk                            	 ərk                            	 ərk                           
proprietress                   	 proprietress*                  	 prəpraɪətrəs                  
stateside                      	 stetsaɪd                       	 stetsaɪd                      
reconciliated                  	 reconciliated*                 	 rɛkənsɪlietɪd                 
prematurely                    	 priməʧʊrli                     	 priməʧʊrli                    
deactivates                    	 deactivates*                   	 diæktɪvets                    
momi                           	 momi*                          	 moʊmi                         
colognes                       	 colognes*                      	 kəloʊnz                       
arles                          	 arles*                         	 ɑrəlz                         
cussedness                     	 cussedness*                    	 kəsədnəs                      
assisting                      	 əsɪstɪŋ                        	 əsɪstɪŋ                       
rn                             	 rn*                            	 rɑn                           
embolus                        	 embolus*                       	 ɪmboʊləs                      
slinks                         	 slinks*                        	 slɪŋks                        
vaudevillian                   	 vɑdvɪljən                      	 vɔdəvɪljən                    
persistently                   	 pərsɪstəntli                   	 pərsɪstəntli                  
worshippers                    	 wərʃɪpərz                      	 wərʃɪpərz                     
runner                         	 rənər                          	 rənər                         
echolocation                   	 ɛkoʊloʊkeʃən                   	 ɛkəloʊkeʃən                   
fraudulent                     	 frɔʤələnt                      	 frɔdulənt                     
intricacy                      	 ɪntrəkəsi                      	 ɪntrəkəsi                     
serialize                      	 sɪriəlaɪz                      	 sɪriəlaɪz                     
roadsteads                     	 roadsteads*                    	 roʊdstɛdz                     
upchucked                      	 upchucked*                     	 əpkəkt                        
redundant                      	 rɪdəndənt                      	 rɪdəndənt                     
caldron                        	 caldron*                       	 kɔldrən                       
scarper                        	 scarper*                       	 skɑrpər                       
skidding                       	 skɪdɪŋ                         	 skɪdɪŋ                        
poppy                          	 pɑpi                           	 pɑpi                          
cakewalk                       	 cakewalk*                      	 kekwɔk                        
liking                         	 laɪkɪŋ                         	 laɪkɪŋ                        
waterspout                     	 waterspout*                    	 wɔtərspaʊt                    
cozier                         	 koʊziər                        	 koʊziər                       
backscratcher                  	 backscratcher*                 	 bækskræʧər                    
ale                            	 el                             	 el                            
camarada                       	 camarada*                      	 kæmərɑdə                      
outsmarted                     	 aʊtsmɑrtəd                     	 aʊtsmɑrtɪd                    
fulminates                     	 fulminates*                    	 fʊlmənets                     
regally                        	 rigəli                         	 rɪgɔli                        
greenwood                      	 grinwʊd                        	 grinwʊd                       
rookie                         	 rʊki                           	 rʊki                          
superimposes                   	 superimposes*                  	 supərəmpoʊzɪz                 
wrecked                        	 rɛkt                           	 rɛkt                          
candidly                       	 kændɪdli                       	 kændɪdli                      
regurgitations                 	 regurgitations*                	 rɪgərʤəteʃənz                 
cockup                         	 cockup*                        	 kɑkəp                         
countering                     	 kaʊnərɪŋ                       	 kaʊnərɪŋ                      
sheared                        	 ʃɪrd                           	 ʃɪrd                          
idolaters                      	 idolaters*                     	 aɪdɑlətərz                    
rapscallion                    	 rapscallion*                   	 rskæljən                      
quaintly                       	 kwentli                        	 kwentli                       
sundogs                        	 sundogs*                       	 səndɔgz                       
sillier                        	 sɪliər                         	 sɪliər                        
burse                          	 bərs                           	 bərs                          
stereoscopic                   	 stereoscopic*                  	 stɛrioʊskɑpɪk                 
sowed                          	 soʊd                           	 soʊd                          
exploding                      	 ɪksploʊdɪŋ                     	 ɪksploʊdɪŋ                    
restrengthen                   	 restrengthen*                  	 rɛstrɛŋθən                    
billyboy                       	 billyboy*                      	 bɪlibɔɪ                       
stereo                         	 stɛrioʊ                        	 stɛrioʊ                       
eggshells                      	 ɛgʃɛlz                         	 ɛgʃɛlz                        
exasperated                    	 ɪgzæspəretɪd                   	 ɪgzæspəretɪd                  
centennial                     	 sɛntɛniəl                      	 sɛntɛniəl                     
dwarfs                         	 dwɔrfs                         	 dwɔrfs                        
flans                          	 flans*                         	 flænz                         
chromes                        	 chromes*                       	 kroʊmz                        
kayaker                        	 kaɪækər                        	 kaɪækər                       
wingman                        	 wɪŋmən                         	 wɪŋmən                        
neoplastic                     	 neoplastic*                    	 nioʊplæstɪk                   
thirdhand                      	 thirdhand*                     	 θərdhænd                      
brokerage                      	 broʊkərɪʤ                      	 broʊkərɪʤ                     
hydrangeas                     	 hydrangeas*                    	 haɪdræŋəz                     
immediately                    	 ɪmidiətli                      	 ɪmidiətli                     
stylized                       	 staɪlaɪzd                      	 staɪlaɪzd                     
warplanes                      	 wɔrplenz                       	 wɔrplenz                      
fitch                          	 fɪʧ                            	 fɪʧ                           
chuckie                        	 ʧəki                           	 ʧəki                          
aspidistra                     	 aspidistra*                    	 əspɪdɪstrə                    
quaintest                      	 quaintest*                     	 kwentəst                      
unbooked                       	 unbooked*                      	 ənbʊkt                        
cholecystectomy                	 cholecystectomy*               	 kɑləsɪstəmi                   
uproarious                     	 uproarious*                    	 əproʊɔriəs                    
mallet                         	 mælɪt                          	 mælɪt                         
fleece                         	 flis                           	 flis                          
hopefulness                    	 hoʊpfəlnɪs                     	 hoʊpfəlnɪs                    
animations                     	 ænəmeʃənz                      	 ænəmeʃənz                     
creepier                       	 creepier*                      	 kripiər                       
transmigration                 	 transmigration*                	 trænzmɪgreʃən                 
witness                        	 wɪtnəs                         	 wɪtnəs                        
easter                         	 istər                          	 istər                         
foiling                        	 fɔɪlɪŋ                         	 fɔɪlɪŋ                        
caus                           	 caus*                          	 kɔz                           
tunelessly                     	 tunelessly*                    	 tunləsli                      
exuberant                      	 ɪgzubərənt                     	 ɪgzubərənt                    
kappa                          	 kæpə                           	 kɑpə                          
monarch                        	 mɑnɑrk                         	 mɑnɑrk                        
reconstructions                	 rikənstrəkʃənz                 	 rikənstrəkʃənz                
kilowatt                       	 kɪləwɑt                        	 kɪləwɑt                       
pumpkin                        	 pəmpkɪn                        	 pəmpkɪn                       
semipros                       	 semipros*                      	 sɛmprəz                       
itemize                        	 aɪtəmaɪz                       	 ɪtimaɪz                       
mutiny                         	 mjutəni                        	 mjutəni                       
drops                          	 drɑps                          	 drɑps                         
blueberries                    	 blubɛriz                       	 blubɛriz                      
reenlists                      	 reenlists*                     	 rinlɪsts                      
grubbiness                     	 grubbiness*                    	 grəbnəs                       
lakes                          	 leks                           	 leks                          
blackmailing                   	 blækmelɪŋ                      	 blækmelɪŋ                     
doudle                         	 doudle*                        	 dədəl                         
tulip                          	 tulɪp                          	 tulɪp                         
tump                           	 tump*                          	 təmp                          
kitbag                         	 kitbag*                        	 kɪtbæg                        
smutty                         	 sməti                          	 sməti                         
sawbones                       	 sawbones*                      	 sɔboʊnz                       
heep                           	 heep*                          	 hip                           
fidelity                       	 faɪdɛləti                      	 faɪdɛləti                     
terek                          	 terek*                         	 tɛrik                         
bloodthirsty                   	 blədθərsti                     	 blədθərsti                    
overexposure                   	 oʊvərɪkspoʊʒər                 	 oʊvərɪkspoʊʒər                
rotations                      	 roʊteʃənz                      	 roʊteʃənz                     
merciful                       	 mərsɪfəl                       	 mərsɪfəl                      
brit                           	 brɪt                           	 brɪt                          
serving                        	 sərvɪŋ                         	 sərvɪŋ                        
charger                        	 ʧɑrʤər                         	 ʧɑrʤər                        
repressions                    	 riprɛʃənz                      	 riprɛʃənz                     
mordecai                       	 mɔrdəkaɪ                       	 mɔrdɛk                        
outfitted                      	 aʊtfɪtɪd                       	 aʊtfɪtɪd                      
hook                           	 hʊk                            	 hʊk                           
sheets                         	 ʃits                           	 ʃits                          
foodstuffs                     	 fudstəfs                       	 fudstəfs                      
crapes                         	 crapes*                        	 kreps                         
loather                        	 loather*                       	 loʊðər                        
navies                         	 neviz                          	 neviz                         
undulate                       	 ənʤəlet                        	 ənʤəlet                       
benj                           	 benj*                          	 bɛnʤ                          
halter                         	 hɔltər                         	 hɔltər                        
compressional                  	 compressional*                 	 kəmprɛʃənəl                   
admitting                      	 ədmɪtɪŋ                        	 ədmɪtɪŋ                       
modifications                  	 mɑdəfəkeʃənz                   	 mɑdəfəkeʃənz                  
doubloons                      	 doubloons*                     	 dəblunz                       
stewed                         	 stud                           	 stud                          
surtax                         	 sərtæks                        	 sərtæks                       
prognosticators                	 prognosticators*               	 prɑgnɑstəketərz               
trek                           	 trɛk                           	 trɛk                          

 
 No IPA translation using library: 353 (35.3%) 
IPA translation that is the same using the library and model: 579 (89.48995363214837%) 
SED Average Including when SED is 0: 121/647 (0.18701700154559506) 
SED Average Excluding when SED is 0: 121/68 (1.7794117647058822) 

 
 Words that have different IPA Transcriptions 
architecturally                	 ɑrkɪtɛkʧərəli                  	 ɑrkətɛkʧərəli                  	 String Edit Distance 1  
shea                           	 ʃe                             	 ʃi                             	 String Edit Distance 1  
asap                           	 esæp                           	 əsæp                           	 String Edit Distance 1  
frere                          	 frɪr                           	 frɛr                           	 String Edit Distance 1  
entendre                       	 ɑntɑndrə                       	 ɛnəndr                         	 String Edit Distance 4  
richter                        	 rɪktər                         	 rɪʧtər                         	 String Edit Distance 1  
buckland                       	 bəklənd                        	 bəklænd                        	 String Edit Distance 1  
podesta                        	 poʊdɛstə                       	 poʊdəstə                       	 String Edit Distance 1  
iowa                           	 aɪəwə                          	 aɪə                            	 String Edit Distance 2  
sodomy                         	 sɑdəmi                         	 sɔdəmi                         	 String Edit Distance 1  
dram                           	 diræm                          	 dræm                           	 String Edit Distance 1  
seminoles                      	 sɛmɪnoʊlz                      	 sɛmənoʊlz                      	 String Edit Distance 1  
neutralization                 	 nutrələzeʃən                   	 nutrəleʃən                     	 String Edit Distance 2  
torsos                         	 tɔrsoʊz                        	 tɔrsəs                         	 String Edit Distance 3  
susan                          	 suzən                          	 susən                          	 String Edit Distance 1  
djakarta                       	 ʤəkɑrtə                        	 dʤəkɑrtə                       	 String Edit Distance 1  
kook                           	 kuk                            	 kʊk                            	 String Edit Distance 1  
machin                         	 mæʧɪn                          	 məʃin                          	 String Edit Distance 3  
interagency                    	 ɪntəreʤənsi                    	 ɪnərɪʤənsi                     	 String Edit Distance 2  
dissociation                   	 dɪsoʊsieʃən                    	 dɪsoʊʃieʃən                    	 String Edit Distance 1  
dobie                          	 dɑbi                           	 doʊbi                          	 String Edit Distance 2  
pino                           	 pinoʊ                          	 paɪnoʊ                         	 String Edit Distance 2  
anaesthesiology                	 ænəsθiziɑləʤi                  	 ænɪsθiʒiɑləʤi                  	 String Edit Distance 2  
dominica                       	 dəmɪnɪkə                       	 doʊmɪnɪkə                      	 String Edit Distance 2  
delphine                       	 dɛlfini                        	 dɪlfaɪn                        	 String Edit Distance 4  
griffon                        	 grɪfən                         	 grɪfɑn                         	 String Edit Distance 1  
vagary                         	 vegəri                         	 vægəri                         	 String Edit Distance 1  
buffo                          	 bufoʊ                          	 bəfoʊ                          	 String Edit Distance 1  
annexing                       	 ənɛksɪŋ                        	 ænɛksɪŋ                        	 String Edit Distance 1  
cuing                          	 kjuɪŋ                          	 kwɪŋ                           	 String Edit Distance 2  
plowed                         	 plaʊd                          	 ploʊd                          	 String Edit Distance 1  
overprotect                    	 oʊvərprətɛkt                   	 oʊvərproʊtɛkt                  	 String Edit Distance 2  
mudra                          	 mədrə                          	 mjudrə                         	 String Edit Distance 2  
automaton                      	 ɔtɑmətɑn                       	 ɔtəmetən                       	 String Edit Distance 3  
dumas                          	 dumɑ                           	 duməz                          	 String Edit Distance 2  
chevrolet                      	 ʃɛvroʊle                       	 ʃɛvrəlɛt                       	 String Edit Distance 4  
privatization                  	 praɪvətəzeʃən                  	 praɪvətɪzeʃən                  	 String Edit Distance 1  
myrmidon                       	 mərmɪdɪn                       	 mɪrmɪdən                       	 String Edit Distance 2  
morris                         	 mɔrɪs                          	 mɔrəs                          	 String Edit Distance 1  
ballplayers                    	 bɔlpleərz                      	 bælpleərz                      	 String Edit Distance 1  
messaging                      	 mɛsɪʤɪŋ                        	 mɛsəʤɪŋ                        	 String Edit Distance 1  
shtick                         	 ʃtɪk                           	 ʃɪk                            	 String Edit Distance 1  
moline                         	 moʊlin                         	 məlaɪn                         	 String Edit Distance 4  
podcast                        	 pɔdkæst                        	 pɑdkæst                        	 String Edit Distance 1  
excalibur                      	 ɛkskæləbər                     	 ɪkskæləbər                     	 String Edit Distance 1  
dramatizing                    	 dræmətaɪzɪŋ                    	 drəmetɪzɪŋ                     	 String Edit Distance 3  
sophocles                      	 sɑfəkliz                       	 səfoʊkəlz                      	 String Edit Distance 5  
fueling                        	 fjulɪŋ                         	 fjuɪŋ                          	 String Edit Distance 1  
mushrooming                    	 məʃrʊmɪŋ                       	 məʃrumɪŋ                       	 String Edit Distance 1  
venezuela                      	 vɛnɪzwelə                      	 vɛnəzuələ                      	 String Edit Distance 3  
angiogram                      	 ænʤioʊgræm                     	 ænʤiəgræm                      	 String Edit Distance 2  
hula                           	 hulə                           	 hjulə                          	 String Edit Distance 1  
podiatrist                     	 pədaɪətrɪst                    	 pədietrəst                     	 String Edit Distance 4  
gaby                           	 gæbi                           	 gebi                           	 String Edit Distance 1  
brutalizes                     	 brutəlaɪzɪz                    	 brutælaɪzɪz                    	 String Edit Distance 1  
astrakhan                      	 æstrəkɑn                       	 æstrekən                       	 String Edit Distance 2  
shenanigans                    	 ʃənænɪgənz                     	 ʃɛnənəgənz                     	 String Edit Distance 3  
isis                           	 aɪsəs                          	 aɪzɪs                          	 String Edit Distance 2  
faltering                      	 fɔltərɪŋ                       	 fɑltərɪŋ                       	 String Edit Distance 1  
brutalized                     	 brutəlaɪzd                     	 brutælaɪzd                     	 String Edit Distance 1  
vaudevillian                   	 vɑdvɪljən                      	 vɔdəvɪljən                     	 String Edit Distance 2  
echolocation                   	 ɛkoʊloʊkeʃən                   	 ɛkəloʊkeʃən                    	 String Edit Distance 2  
fraudulent                     	 frɔʤələnt                      	 frɔdulənt                      	 String Edit Distance 2  
outsmarted                     	 aʊtsmɑrtəd                     	 aʊtsmɑrtɪd                     	 String Edit Distance 1  
regally                        	 rigəli                         	 rɪgɔli                         	 String Edit Distance 2  
kappa                          	 kæpə                           	 kɑpə                           	 String Edit Distance 1  
itemize                        	 aɪtəmaɪz                       	 ɪtimaɪz                        	 String Edit Distance 2  
mordecai                       	 mɔrdəkaɪ                       	 mɔrdɛk                         	 String Edit Distance 3  
