word                           	 ipa                            	 ipa_model                      
vouching                       	 vaʊʧɪŋ                         	 vaʊʧɪŋ                        
sensitivities                  	 sɛnsɪtɪvɪtiz                   	 sɛnsɪtɪvɪtiz                  
mycologist                     	 mycologist*                    	 məkɑləʤəst                    
bogus                          	 boʊgəs                         	 boʊgəs                        
cadillac                       	 kædəlæk                        	 kædɪlæk                       
runaways                       	 rənəwez                        	 runəwez                       
rubberneckers                  	 rubberneckers*                 	 rəbərnɛkərz                   
legumes                        	 lɛgjumz                        	 lɛgjumz                       
pumice                         	 pəməs                          	 pjumɪs                        
gnawing                        	 nɔɪŋ                           	 nɔɪŋ                          
year                           	 jɪr                            	 jɪr                           
juked                          	 juked*                         	 ʤukt                          
redefining                     	 ridɪfaɪnɪŋ                     	 ridɪfaɪnɪŋ                    
ropers                         	 roʊpərz                        	 roʊpərz                       
dehumanise                     	 dehumanise*                    	 dɛhjəmenɪs                    
carbon                         	 kɑrbən                         	 kɑrbən                        
sadists                        	 sadists*                       	 sedəsts                       
unfocused                      	 ənfoʊkəst                      	 ənfoʊkəst                     
levelled                       	 lɛvəld                         	 lɛvəld                        
triceratops                    	 traɪsɛrətɔps                   	 trɪsəretəps                   
combust                        	 kəmbəst                        	 kɑmbəst                       
surveys                        	 sərvez                         	 sərvez                        
faltered                       	 fɑltərd                        	 fɑltərd                       
gaul                           	 gɔl                            	 gɔl                           
oxidized                       	 ɑksədaɪzd                      	 ɑksədaɪzd                     
snatch                         	 snæʧ                           	 snæʧ                          
eyeless                        	 aɪləs                          	 aɪləs                         
epicondyle                     	 epicondyle*                    	 ɛpɪkɑndəl                     
twitchy                        	 twitchy*                       	 twɪʧi                         
whiffed                        	 whiffed*                       	 wɪft                          
sickbeds                       	 sickbeds*                      	 sɪkbɛdz                       
gorgeous                       	 gɔrʤəs                         	 gɔrʤəs                        
nae                            	 nae*                           	 ne                            
brass                          	 bræs                           	 bræs                          
wonderland                     	 wəndərlænd                     	 wəndərlænd                    
vetting                        	 vɛtɪŋ                          	 vɛtɪŋ                         
ignominious                    	 ɪgnəmɪniəs                     	 ɪgnəmɪniəs                    
enlightened                    	 ɛnlaɪtənd                      	 ɛnlaɪtənd                     
roistering                     	 roistering*                    	 rɔɪstərɪŋ                     
piston                         	 pɪstən                         	 pɪstən                        
merpeople                      	 merpeople*                     	 mərpipəl                      
kleptomaniac                   	 klɛptəmeniæk                   	 klɛptəmeniæk                  
justified                      	 ʤəstəfaɪd                      	 ʤəstəfaɪd                     
contravene                     	 kɑntrəvin                      	 kɑntrəvin                     
reabsorption                   	 reabsorption*                  	 riəbzɔrpʃən                   
dilator                        	 dilator*                       	 daɪlətər                      
ardency                        	 ardency*                       	 ɑrdənsi                       
faced                          	 fest                           	 fest                          
mesas                          	 mesas*                         	 mizəz                         
unharmed                       	 ənhɑrmd                        	 ənhɑrmd                       
comprehensible                 	 kɑmprihɛnsəbəl                 	 kɑmprihɛnsəbəl                
simmer                         	 sɪmər                          	 sɪmər                         
degreasing                     	 degreasing*                    	 dɪgrisɪŋ                      
electrification                	 ɪlɛktrəfɪkeʃən                 	 ɪlɛktrəfɪkeʃən                
ceramics                       	 səræmɪks                       	 səræmɪks                      
friendlier                     	 frɛndliər                      	 frɛndliər                     
meaningless                    	 minɪŋləs                       	 minɪŋləs                      
unhandsome                     	 unhandsome*                    	 ənhænsəm                      
thicke                         	 thicke*                        	 θɪk                           
flatbed                        	 flætbɛd                        	 flætbɛd                       
solvents                       	 sɔlvənts                       	 sɔlvənts                      
potheads                       	 potheads*                      	 pɑðhɛdz                       
silently                       	 saɪləntli                      	 saɪləntli                     
appreciable                    	 əpriʃəbəl                      	 əpriʃəbəl                     
wallops                        	 wɑləps                         	 wɑləps                        
ironsides                      	 aɪərnsaɪdz                     	 aɪrənsaɪdz                    
moshing                        	 moshing*                       	 mɔʃɪŋ                         
unpredict                      	 unpredict*                     	 ənprɪdɪkt                     
conceptualized                 	 conceptualized*                	 kənsɛpʧuəlzd                  
center                         	 sɛnər                          	 sɛntər                        
diminishment                   	 dɪmɪnɪʃmənt                    	 dɪmɪnɪʃmənt                   
elusion                        	 elusion*                       	 ɪluʒən                        
precis                         	 presi                          	 presi                         
philosophizes                  	 philosophizes*                 	 fəlɑsəfaɪzɪz                  
respond                        	 rɪspɑnd                        	 rɪspɑnd                       
foppishness                    	 foppishness*                   	 fɑpɪʃnəs                      
longshoreman                   	 longshoreman*                  	 lɔŋʃɔrmən                     
pupil                          	 pjupəl                         	 pjupəl                        
ibm                            	 ibm*                           	 ɪbm                           
treacherously                  	 treacherously*                 	 trɛʧərəsli                    
marinas                        	 mərinəz                        	 mərinəz                       
officiousness                  	 officiousness*                 	 əfɪʃəsnɪs                     
preconceived                   	 prikənsivd                     	 prikənsivd                    
favour                         	 fevər                          	 fevər                         
reserving                      	 rɪzərvɪŋ                       	 rɪzərvɪŋ                      
ruggedly                       	 rəgədli                        	 rəgədli                       
pilcher                        	 pɪlʧər                         	 pɪlʧər                        
detune                         	 detune*                        	 dɪtun                         
habiliment                     	 habiliment*                    	 həbɪlɪmənt                    
observational                  	 observational*                 	 ɑbzərveʃənəl                  
uniform                        	 junəfɔrm                       	 junəfɔrm                      
mungo                          	 məŋgoʊ                         	 məŋgoʊ                        
superceded                     	 superceded*                    	 supərsidɪd                    
kazi                           	 kazi*                          	 kəzi                          
representations                	 rɛprəzənteʃənz                 	 rɛprəzənteʃənz                
belle                          	 bɛl                            	 bɛl                           
congratulated                  	 kəngræʧəletɪd                  	 kəngræʧəletɪd                 
boomtown                       	 bumtaʊn                        	 bumtoʊn                       
cage                           	 keʤ                            	 keʤ                           
preperitoneal                  	 preperitoneal*                 	 pripɪrɪtoʊniəl                
confounds                      	 kənfaʊndz                      	 kənfaʊndz                     
unmount                        	 unmount*                       	 ənmaʊnt                       
alternation                    	 ɔltərneʃən                     	 ɔltərneʃən                    
flanken                        	 flanken*                       	 flæŋkən                       
clos                           	 klɑs                           	 kloʊs                         
carrell                        	 kɑrel                          	 kærɛl                         
plebian                        	 plebian*                       	 plibiən                       
haff                           	 hæf                            	 hæf                           
briton                         	 brɪtən                         	 brɪtən                        
yippie                         	 yippie*                        	 jɪpi                          
groaned                        	 groʊnd                         	 groʊnd                        
beads                          	 bidz                           	 bidz                          
pinches                        	 pinches*                       	 pɪnʧɪz                        
causations                     	 causations*                    	 kɔzeʃənz                      
reverent                       	 rɛvərənt                       	 rɛvərənt                      
overran                        	 oʊvərræn                       	 oʊvərræn                      
elevato                        	 elevato*                       	 ɛləvetoʊ                      
woofs                          	 woofs*                         	 wufs                          
watchings                      	 watchings*                     	 wɑʧɪŋz                        
google                         	 gugəl                          	 gugəl                         
fulani                         	 fulɑni                         	 fəleni                        
muley                          	 muley*                         	 mjuli                         
disabused                      	 dɪsəbjuzd                      	 dɪsəbjuzd                     
procreative                    	 procreative*                   	 proʊkrietɪv                   
bolognas                       	 bolognas*                      	 bəloʊŋɑz                      
eleventh                       	 ilɛvənθ                        	 ilɛvənθ                       
necrophagous                   	 necrophagous*                  	 nɛkrəfəgəs                    
concentrations                 	 kɑnsəntreʃənz                  	 kɑnsəntreʃənz                 
worldwide                      	 wərldwaɪd                      	 wərldwaɪd                     
cathouses                      	 cathouses*                     	 kæθaʊsɪz                      
deadlocked                     	 dɛdlɑkt                        	 dɛdlɑkt                       
tails                          	 telz                           	 telz                          
joiner                         	 ʤɔɪnər                         	 ʤɔɪnər                        
gloat                          	 gloʊt                          	 gloʊt                         
martyrized                     	 martyrized*                    	 mɑrtəraɪzd                    
reinvested                     	 riɪnvɛstɪd                     	 riɪnvɛstɪd                    
cord                           	 kɔrd                           	 kɔrd                          
flintstone                     	 flɪntstoʊn                     	 flɪntstoʊn                    
disposables                    	 dɪspoʊzəbəlz                   	 dɪspoʊzəbəlz                  
parentless                     	 parentless*                    	 pɛrəntləs                     
triage                         	 traɪɪʤ                         	 traɪɪʤ                        
zoologist                      	 zoʊɑləʤəst                     	 zoʊɑləʤəst                    
colic                          	 colic*                         	 kɑlɪk                         
electability                   	 ɪlɛktəbɪləti                   	 ɪlɛktəbɪləti                  
closets                        	 klɑzəts                        	 klɑzəts                       
ukrainians                     	 jukreniənz                     	 jukreniənz                    
wakes                          	 weks                           	 weks                          
psychogenic                    	 saɪkoʊʤɛnɪk                    	 saɪkəʤɛnɪk                    
downcast                       	 daʊnkæst                       	 daʊnkæst                      
configurating                  	 configurating*                 	 kənfɪgjəretɪŋ                 
ensured                        	 ɪnʃʊrd                         	 ɪnʃʊrd                        
harvests                       	 hɑrvəsts                       	 hɑrvəsts                      
spumoni                        	 spumoni*                       	 spəmɑni                       
screwless                      	 screwless*                     	 skruləs                       
dodd                           	 dɑd                            	 dɑd                           
microwaved                     	 maɪkroʊwevd                    	 maɪkroʊwevd                   
oomph                          	 umf                            	 umf                           
gladiola                       	 gladiola*                      	 glædioʊlə                     
stalkers                       	 stɔkərz                        	 stɔkərz                       
gristles                       	 gristles*                      	 grɪsəlz                       
slutty                         	 sləti                          	 sləti                         
directors                      	 dɪrɛktərz                      	 dɪrɛktərz                     
promiscuous                    	 proʊmɪskwəs                    	 proʊmɪskwəs                   
bangalow                       	 bangalow*                      	 bæŋgəloʊ                      
landing                        	 lændɪŋ                         	 lændɪŋ                        
smoothness                     	 smuðnəs                        	 smuðnəs                       
banbury                        	 bænbɛri                        	 bænbjəri                      
trun                           	 trun*                          	 trən                          
flotilla                       	 floʊtɪlə                       	 floʊtɪlə                      
yang                           	 jæŋ                            	 jæŋ                           
bars                           	 bɑrz                           	 bɑrz                          
lames                          	 lames*                         	 lemz                          
organa                         	 organa*                        	 ɔrgænə                        
lily                           	 lɪli                           	 lɪli                          
commendations                  	 commendations*                 	 kɑməndeʃənz                   
bootless                       	 bootless*                      	 butləs                        
err                            	 ɛr                             	 ɛr                            
grayed                         	 grayed*                        	 gred                          
trolled                        	 trolled*                       	 troʊld                        
paisans                        	 paisans*                       	 pezənz                        
milkmaid                       	 milkmaid*                      	 mɪlkmed                       
scuff                          	 skəf                           	 skəf                          
retrack                        	 retrack*                       	 ritræk                        
feuilleton                     	 feuilleton*                    	 fjuɪlətən                     
oscillator                     	 ɑsəletər                       	 ɑsəletər                      
blossom                        	 blɑsəm                         	 blɑsəm                        
tabor                          	 tebər                          	 tebər                         
paramecium                     	 pɛrəmisiəm                     	 pɛrəmɛʃəm                     
stick                          	 stɪk                           	 stɪk                          
hemp                           	 hɛmp                           	 hɛmp                          
legible                        	 lɛʤəbəl                        	 lɛʤəbəl                       
cupboards                      	 kəbərdz                        	 kəbərdz                       
defection                      	 dɪfɛkʃən                       	 dɪfɛkʃən                      
choya                          	 choya*                         	 ʧɔɪə                          
beneficially                   	 bɛnəfɪʃəli                     	 bɛnəfɪʃəli                    
wrought                        	 rɔt                            	 rɔt                           
varietals                      	 vəraɪətəlz                     	 vəraɪətəlz                    
lexicon                        	 lɛksɪkɑn                       	 lɛksɪkɑn                      
deemed                         	 dimd                           	 dimd                          
tailspin                       	 telspɪn                        	 telspɪn                       
endured                        	 ɪndʊrd                         	 ɪndʊrd                        
bundle                         	 bəndəl                         	 bəndəl                        
propagate                      	 prɑpəget                       	 prɑpəget                      
exerting                       	 ɪgzərtɪŋ                       	 ɪgzərtɪŋ                      
rectangles                     	 rɛktæŋgəlz                     	 rɛktæŋgəlz                    
nonrestricted                  	 nɑnrɪstrɪktɪd                  	 nɑnristrɪktɪd                 
tertius                        	 tərʃjɪs                        	 tərʃəs                        
freeware                       	 friwɛr                         	 friwɛr                        
subjugation                    	 subjugation*                   	 səbʤəgeʃən                    
lupine                         	 lupaɪn                         	 lupən                         
putterer                       	 pətərər                        	 pətərər                       
directives                     	 dɪrɛktɪvz                      	 dɪrɛktɪvz                     
texas                          	 tɛksəs                         	 tɛksəs                        
slapshot                       	 slapshot*                      	 slæpʃɑt                       
stravinsky                     	 strəvɪnski                     	 strævənski                    
thrall                         	 θrɔl                           	 θrɔl                          
ria                            	 riə                            	 riə                           
dirties                        	 dirties*                       	 dərtiz                        
organize                       	 ɔrgənaɪz                       	 ɔrgənaɪz                      
untranslatable                 	 untranslatable*                	 əntrænzletəbəl                
gunnels                        	 gənəlz                         	 gənəlz                        
peewees                        	 peewees*                       	 piwiz                         
flavors                        	 flevərz                        	 flevərz                       
burlesque                      	 bərlɛsk                        	 bərlɛsk                       
laryngoscope                   	 lɑrɪnʤəskoʊp                   	 lɑrɪŋgoʊp                     
hex                            	 hɛks                           	 hɛks                          
litmus                         	 lɪtməs                         	 lɪtməs                        
cartload                       	 cartload*                      	 kɑrtloʊd                      
traipses                       	 traipses*                      	 trepsɪz                       
dungaree                       	 dungaree*                      	 dəngɛri                       
sequelae                       	 sequelae*                      	 sikwəli                       
straggled                      	 strægəld                       	 strægəld                      
rightist                       	 raɪtɪst                        	 raɪtɪst                       
heller                         	 hɛlər                          	 hɛlər                         
unambiguously                  	 ənæmbɪgjuəsli                  	 ənæmbɪgjuəsli                 
magistrates                    	 mæʤɪstrets                     	 mæʤɪstrets                    
bennies                        	 bennies*                       	 bɛniz                         
touchdown                      	 təʧdaʊn                        	 təʧdaʊn                       
kidnapping                     	 kɪdnæpɪŋ                       	 kɪdnæpɪŋ                      
colourless                     	 colourless*                    	 kɑlərləs                      
phillippi                      	 fəlipi                         	 fɪlɪpi                        
confidence                     	 kɑnfədɛns                      	 kɑnfədɛns                     
assassins                      	 əsæsənz                        	 əsæsənz                       
suez                           	 suɛz                           	 suz                           
praise                         	 prez                           	 prez                          
peeks                          	 piks                           	 piks                          
roofs                          	 rufs                           	 rufs                          
stimulation                    	 stɪmjəleʃən                    	 stɪmjəleʃən                   
management                     	 mænɪʤmənt                      	 mænɪʤmənt                     
authorises                     	 authorises*                    	 ɔθəraɪzɪz                     
monstrously                    	 monstrously*                   	 mɑnstrəsli                    
cherries                       	 ʧɛriz                          	 ʧɛriz                         
cough                          	 kɔf                            	 kɔf                           
vivacious                      	 vəveʃəs                        	 vɪveʃəs                       
ticks                          	 tɪks                           	 tɪks                          
scrutinizing                   	 skrutənaɪzɪŋ                   	 skrutinɪŋ                     
dishpan                        	 dishpan*                       	 dɪʃpæn                        
leftovers                      	 lɛftoʊvərz                     	 lɛftoʊvərz                    
stock                          	 stɑk                           	 stɑk                          
cautiously                     	 kɔʃəsli                        	 kɔʃəsli                       
squelches                      	 squelches*                     	 skwɛlʧəz                      
interspace                     	 interspace*                    	 ɪntərspes                     
snoopers                       	 snoopers*                      	 snupərz                       
gunboats                       	 gənboʊts                       	 gənboʊts                      
waste                          	 west                           	 west                          
paints                         	 pents                          	 pents                         
vivat                          	 vivat*                         	 vɪvət                         
clothing                       	 kloʊðɪŋ                        	 kloʊðɪŋ                       
dhu                            	 dhu*                           	 du                            
lewis                          	 luɪs                           	 luɪs                          
smelliest                      	 smelliest*                     	 smɛliəst                      
median                         	 midiən                         	 midiən                        
multivitamin                   	 məltivaɪtəmən                  	 məltɪvətəmən                  
hist                           	 hist*                          	 hɪst                          
huron                          	 hjʊrɑn                         	 hjʊrən                        
stimulating                    	 stɪmjəletɪŋ                    	 stɪmjəletɪŋ                   
firstly                        	 fərstli                        	 fərstli                       
rimrock                        	 rimrock*                       	 rɪmrɑk                        
chisels                        	 ʧɪzəlz                         	 ʧɪzəlz                        
vomitoria                      	 vomitoria*                     	 vɑmətɔriə                     
nene                           	 nin                            	 nin                           
shepherd                       	 ʃɛpərd                         	 ʃɛpərd                        
ubiquity                       	 jubɪkwɪti                      	 jubɪkwɪti                     
fucked                         	 fəkt                           	 fəkt                          
lanes                          	 lenz                           	 lenz                          
matriarchs                     	 matriarchs*                    	 metriɑrks                     
sarongs                        	 sərɔŋz                         	 sərɔŋz                        
lodged                         	 lɑʤd                           	 lɑʤd                          
subcultures                    	 səbkəlʧərz                     	 səbkəlʧərz                    
breadstuffs                    	 breadstuffs*                   	 brɛdstəfs                     
withstanding                   	 wɪθstændɪŋ                     	 wɪθstændɪŋ                    
grotto                         	 grɑtoʊ                         	 grɑtoʊ                        
ug                             	 ug*                            	 əg                            
narcos                         	 nɑrkoʊs                        	 nɑrkoʊz                       
directional                    	 dɪrɛkʃɪnəl                     	 dɪrɛkʃɪnəl                    
modifying                      	 mɑdəfaɪɪŋ                      	 mɑdəfaɪɪŋ                     
retrocede                      	 retrocede*                     	 ritroʊsid                     
incursions                     	 ɪnkərʒənz                      	 ɪnkərʒənz                     
deftness                       	 deftness*                      	 dɛftnəs                       
historical                     	 hɪstɔrɪkəl                     	 hɪstɔrɪkəl                    
deactivator                    	 deactivator*                   	 diæktɪvetər                   
shirty                         	 shirty*                        	 ʃərti                         
surpluses                      	 sərpləsɪz                      	 sərplusɪz                     
corticospinal                  	 corticospinal*                 	 kɔrtɪkoʊspɪnəl                
pseudo                         	 sudoʊ                          	 sudoʊ                         
nauseous                       	 nɔʃəs                          	 nɔʃəs                         
prosecuted                     	 prɑsɪkjutɪd                    	 prɑsɪkjutɪd                   
derogated                      	 derogated*                     	 dɛrəgetɪd                     
invalidated                    	 ɪnvælɪdetɪd                    	 ɪnvælɪdetɪd                   
convector                      	 convector*                     	 kənvɛktər                     
sagging                        	 sægɪŋ                          	 sægɪŋ                         
nonrandom                      	 nonrandom*                     	 nɑnrændəm                     
weaponry                       	 wɛpənri                        	 wɛpənri                       
forming                        	 fɔrmɪŋ                         	 fɔrmɪŋ                        
overstaffed                    	 oʊvərstæft                     	 oʊvərstæft                    
toads                          	 toʊdz                          	 toʊdz                         
intestines                     	 ɪntɛstənz                      	 ɪntɛstənz                     
ringtail                       	 ringtail*                      	 rɪŋtel                        
flush                          	 fləʃ                           	 fləʃ                          
clown                          	 klaʊn                          	 klaʊn                         
chitlin                        	 ʧɪtlɪn                         	 ʧɪtlɪn                        
nuggets                        	 nəgəts                         	 nəgəts                        
enchiladas                     	 enchiladas*                    	 ɛnʧɪlædəz                     
kidnaps                        	 kɪdnæps                        	 kɪdnæps                       
stratagem                      	 strætəʤəm                      	 strætəʤəm                     
bedsore                        	 bedsore*                       	 bɛdsɔr                        
titmice                        	 titmice*                       	 tɪtmɪs                        
handicapping                   	 hændikæpɪŋ                     	 hændikæpɪŋ                    
rhea                           	 riə                            	 riə                           
edematous                      	 edematous*                     	 ɛdəmetəs                      
sinuses                        	 saɪnəsəz                       	 saɪnəsəz                      
perfectly                      	 pərfəktli                      	 pərfəktli                     
matriarch                      	 metriɑrk                       	 metriɑrk                      
roadside                       	 roʊdsaɪd                       	 roʊdsaɪd                      
carrousel                      	 kɛrəsɛl                        	 kɛrəsɛl                       
swayback                       	 swayback*                      	 swebæk                        
grenadier                      	 grenadier*                     	 grɛnədɪr                      
biologists                     	 baɪɑləʤɪsts                    	 baɪɑləʤɪsts                   
carriage                       	 kɛrəʤ                          	 kɛrɪʤ                         
commuters                      	 kəmjutərz                      	 kəmjutərz                     
harmonia                       	 hɑrmoʊniə                      	 hɑrmoʊniə                     
cannulation                    	 cannulation*                   	 kænjəleʃən                    
element                        	 ɛləmənt                        	 ɛləmənt                       
consonant                      	 kɑnsənənt                      	 kɑnsənənt                     
touts                          	 taʊts                          	 taʊts                         
twang                          	 twɑŋ                           	 twɑŋ                          
gether                         	 gether*                        	 gɛðər                         
ultimo                         	 ultimo*                        	 əltəmoʊ                       
crooked                        	 krʊkəd                         	 krʊkəd                        
enfolding                      	 enfolding*                     	 ɪnfoʊldɪŋ                     
maud                           	 mɔd                            	 mɔd                           
empirics                       	 empirics*                      	 ɛmpɪrəks                      
smash                          	 smæʃ                           	 smæʃ                          
defenseless                    	 dɪfɛnsləs                      	 dɪfɛnslɪs                     
contributions                  	 kɑntrəbjuʃənz                  	 kɑntrəbjuʃənz                 
triton                         	 traɪtən                        	 trɪtən                        
surrealistic                   	 sərilɪstɪk                     	 sərilɪstɪk                    
automated                      	 ɔtəmetɪd                       	 ɔtəmetɪd                      
newsmen                        	 nuzmɪn                         	 nuzmɪn                        
labelling                      	 labelling*                     	 lebəlɪŋ                       
sail                           	 sel                            	 sel                           
nuchal                         	 nuchal*                        	 nəʧəl                         
eyelid                         	 aɪlɪd                          	 aɪlɪd                         
ripen                          	 raɪpən                         	 raɪpən                        
oldie                          	 oʊldi                          	 oʊldi                         
stivers                        	 staɪvərz                       	 stɪvərz                       
triskaidekaphobia              	 triskaidekaphobia*             	 trɪskediə                     
discriminative                 	 dɪskrɪmənətɪv                  	 dɪskrɪmənətɪv                 
put                            	 pʊt                            	 pʊt                           
messes                         	 mɛsɪz                          	 mɛsɪz                         
invites                        	 ɪnvaɪts                        	 ɪnvaɪts                       
galoshes                       	 gəlɑʃɪz                        	 gəlɑʃɪz                       
motivating                     	 moʊtəvetɪŋ                     	 moʊtəvetɪŋ                    
rotch                          	 rotch*                         	 rɑʧ                           
impermeable                    	 impermeable*                   	 ɪmpərmiəbəl                   
governs                        	 gəvərnz                        	 gəvərnz                       
prioritized                    	 praɪɔrətaɪzd                   	 praɪərɪtəst                   
saurian                        	 saurian*                       	 sɔriən                        
prolixity                      	 prolixity*                     	 proʊlɪksəti                   
unapproved                     	 ənəpruvd                       	 ənəpruvd                      
totty                          	 tɑti                           	 tɑti                          
donning                        	 dɑnɪŋ                          	 dɑnɪŋ                         
arrogantly                     	 ɛrəgəntli                      	 ɛrəgəntli                     
insectivore                    	 insectivore*                   	 ɪnsɛktɪvər                    
ovulations                     	 oʊvjəleʃənz                    	 oʊvjəleʃənz                   
cellars                        	 sɛlərz                         	 sɛlərz                        
own                            	 oʊn                            	 oʊn                           
gingham                        	 gɪŋəm                          	 gɪŋəm                         
greatness                      	 gretnəs                        	 gretnəs                       
bucketful                      	 bucketful*                     	 bəkətfʊl                      
subfloors                      	 subfloors*                     	 səbflɔrz                      
jauntily                       	 ʤɔntəli                        	 ʤɔntəli                       
pesetas                        	 pəsetəz                        	 pəsetəz                       
redbones                       	 redbones*                      	 ridboʊnz                      
fuckhead                       	 fuckhead*                      	 fəkhɛd                        
approaching                    	 əproʊʧɪŋ                       	 əproʊʧɪŋ                      
obviousness                    	 obviousness*                   	 ɑbviəsnəs                     
recommend                      	 rɛkəmɛnd                       	 rɛkəmɛnd                      
verify                         	 vɛrəfaɪ                        	 vɛrəfaɪ                       
barranca                       	 barranca*                      	 bɛrənkɑ                       
investiture                    	 ɪnvɛstəʧər                     	 ɪnvɛstətər                    
stingrays                      	 stingrays*                     	 stɪŋgrez                      
washwoman                      	 washwoman*                     	 wɑʃwʊmən                      
bassist                        	 besɪst                         	 besɪst                        
methotrexate                   	 mɛθoʊtrɛkset                   	 mɛθətrɛkset                   
varicose                       	 varicose*                      	 vɛrəkoʊs                      
valium                         	 væliəm                         	 væljəm                        
bodywork                       	 bodywork*                      	 bɑdiwərk                      
goblets                        	 goblets*                       	 gɑbləts                       
suds                           	 sədz                           	 sədz                          
booboo                         	 booboo*                        	 bubu                          
eviscerates                    	 eviscerates*                   	 əvɪsərets                     
madonnas                       	 madonnas*                      	 mədɑnəz                       
neurologic                     	 nʊrəlɑʤɪk                      	 nʊrəlɑʤɪk                     
reprise                        	 rɪpriz                         	 rɪpriz                        
quintillions                   	 quintillions*                  	 kwɪntɪljənz                   
jasmin                         	 ʤæzmɪn                         	 ʤæzmɪn                        
technicolor                    	 tɛknɪkələr                     	 tɛknɪkələr                    
therapists                     	 θɛrəpɪsts                      	 θɛrəpɪsts                     
destabilization                	 distebələzeʃən                 	 distæbɪlɪzeʃən                
tercel                         	 tərsəl                         	 tərsəl                        
childproof                     	 childproof*                    	 ʧaɪldpruf                     
boundless                      	 baʊndləs                       	 baʊndləs                      
reliant                        	 rɪlaɪənt                       	 rɪlaɪənt                      
woodbury                       	 wʊdbɛri                        	 wʊdbjəri                      
demi                           	 dɛmi                           	 dɛmi                          
nebuchadnezzar                 	 nebuchadnezzar*                	 nɛbjəʧædnər                   
jammers                        	 ʤæmərz                         	 ʤæmərz                        
portico                        	 pɔrtəkoʊ                       	 pɔrtɪkoʊ                      
reassessment                   	 riəsɛsmənt                     	 riəsɛsmənt                    
flexed                         	 flɛkst                         	 flɛkst                        
desk                           	 dɛsk                           	 dɛsk                          
codebooks                      	 codebooks*                     	 koʊdbʊks                      
opportunists                   	 ɑpərtunɪsts                    	 ɑpərtunɪsts                   
contortionists                 	 contortionists*                	 kəntɔrʃənɪsts                 
glasswork                      	 glasswork*                     	 glæswərk                      
singly                         	 sɪŋgli                         	 sɪŋgli                        
documentation                  	 dɑkjəmɛnteʃən                  	 dɑkjəmɛnteʃən                 
superheated                    	 supərhitɪd                     	 supərhitɪd                    
tos                            	 tos*                           	 toʊz                          
precepts                       	 prisɛpts                       	 prisɛpts                      
surrendered                    	 sərɛndərd                      	 sərɛndərd                     
narcoleptic                    	 narcoleptic*                   	 nɑrkoʊlɛptɪk                  
chimes                         	 ʧaɪmz                          	 ʧaɪmz                         
halas                          	 hɑləz                          	 heləz                         
swarmed                        	 swɔrmd                         	 swɔrmd                        
slanting                       	 slæntɪŋ                        	 slæntɪŋ                       
kickboxing                     	 kickboxing*                    	 kɪkbɑksɪŋ                     
donald                         	 dɑnəld                         	 doʊnəld                       
yappers                        	 yappers*                       	 jæpərz                        
reconcentration                	 reconcentration*               	 rɛkənsɛntreʃən                
goslings                       	 goslings*                      	 gɑslɪŋz                       
pursuers                       	 pərsuərz                       	 pərsuərz                      
mere                           	 mɪr                            	 mɪr                           
advertise                      	 ædvərtaɪz                      	 ædvərtaɪz                     
regularize                     	 regularize*                    	 rɛgjələraɪz                   
occult                         	 əkəlt                          	 əkəlt                         
digitalized                    	 digitalized*                   	 dɪʤətælaɪzd                   
engrossing                     	 ɪngroʊsɪŋ                      	 ɪngroʊsɪŋ                     
winningest                     	 wɪnɪŋəst                       	 wɪnɪnɪŋ                       
carillons                      	 carillons*                     	 kɛrɪlənz                      
cinematographers               	 cinematographers*              	 sɪnɪmətɑgrəfərz               
activity                       	 æktɪvɪti                       	 æktɪvɪti                      
scapegoating                   	 skepgoʊtɪŋ                     	 skepgoʊtɪŋ                    
lacerations                    	 læsəreʃənz                     	 læsəreʃənz                    
supplements                    	 səpləmɛnts                     	 səpləmɛnts                    
dehydrating                    	 dehydrating*                   	 dihaɪdretɪŋ                   
curative                       	 kjʊrətɪv                       	 kjʊrətɪv                      
lateral                        	 lætərəl                        	 lætərəl                       
moderately                     	 mɑdərətli                      	 mɑdərətli                     
coincidences                   	 koʊɪnsədənsɪz                  	 koʊɪnsədənsɪz                 
notarized                      	 notarized*                     	 noʊtəraɪzd                    
partie                         	 partie*                        	 pɑrti                         
trickery                       	 trɪkəri                        	 trɪkəri                       
recalculated                   	 rikælkjəletɪd                  	 rikælkjəletɪd                 
zee                            	 zi                             	 zi                            
coin                           	 kɔɪn                           	 kɔɪn                          
materialistic                  	 mətɪriəlɪstɪk                  	 mətɪriəlɪstɪk                 
passover                       	 pæsoʊvər                       	 pæsoʊvər                      
yer                            	 jər                            	 jər                           
variance                       	 vɛriəns                        	 vɛriəns                       
proximal                       	 prɑksəməl                      	 prɑksəməl                     
legwork                        	 lɛgwərk                        	 lɛgwərk                       
heavenward                     	 heavenward*                    	 hɛvənwərd                     
muzzler                        	 muzzler*                       	 məzlər                        
idiotically                    	 ɪdiɑtɪkli                      	 ɪdiɑtɪkli                     
sublieutenant                  	 sublieutenant*                 	 səbliutɛnənt                  
biz                            	 bɪz                            	 bɪz                           
blackhead                      	 blackhead*                     	 blækhɛd                       
athletically                   	 æθlɛtɪkli                      	 æθlɛtɪkli                     
earl                           	 ərl                            	 ərl                           
vaunce                         	 vaunce*                        	 vɔns                          
berk                           	 bərk                           	 bərk                          
gurney                         	 gərni                          	 gərni                         
johnnie                        	 ʤɑni                           	 ʤɑni                          
regimental                     	 rɛʤəmɛntəl                     	 rɛʤəmɛntəl                    
passivity                      	 pəsɪvɪti                       	 pəsɪvɪti                      
irrationally                   	 ɪræʃənəli                      	 ɪræʃənəli                     
enhances                       	 ɛnhænsɪz                       	 ɛnhænsɪz                      
botches                        	 botches*                       	 bɑʧɪz                         
illicitness                    	 illicitness*                   	 ɪlɪsətnəs                     
sands                          	 sændz                          	 sændz                         
delete                         	 dɪlit                          	 dɪlit                         
tang                           	 tɑŋ                            	 tɑŋ                           
subjected                      	 səbʤɛktɪd                      	 səbʤɛktɪd                     
stitch                         	 stɪʧ                           	 stɪʧ                          
repossess                      	 ripəzɛs                        	 ripəzɛs                       
rough                          	 rəf                            	 rəf                           
kenner                         	 kɛnər                          	 kɛnər                         
glutathione                    	 glutathione*                   	 gluteθiən                     
reverting                      	 rɪvərtɪŋ                       	 rɪvərtɪŋ                      
fluoride                       	 flʊraɪd                        	 flʊraɪd                       
playmates                      	 plemets                        	 plemets                       
tora                           	 tora*                          	 tɔrə                          
spouted                        	 spaʊtəd                        	 spaʊtəd                       
nationalization                	 næʃənələzeʃən                  	 næʃənəlaɪzeʃən                
confidentially                 	 kɑnfədɛnʃəli                   	 kɑnfədɛnʃəli                  
espouses                       	 ɪspaʊzɪz                       	 ɪspaʊzɪz                      
untangles                      	 untangles*                     	 əntæŋgəlz                     
cholecystitis                  	 cholecystitis*                 	 kɑləsɪstɪs                    
cort                           	 kɔrt                           	 kɔrt                          
vertigos                       	 vertigos*                      	 vərtɪgoʊz                     
heals                          	 hilz                           	 hilz                          
unselfish                      	 unselfish*                     	 ənsɛlfɪʃ                      
stage                          	 steʤ                           	 steʤ                          
cuckooing                      	 cuckooing*                     	 kəkuɪŋ                        
mulberry                       	 məlbɛri                        	 məlbɛri                       
flightless                     	 flaɪtləs                       	 flaɪtləs                      
hyphema                        	 hyphema*                       	 haɪfəmə                       
frenzies                       	 frɛnziz                        	 frɛnziz                       
swindling                      	 swɪndlɪŋ                       	 swɪndlɪŋ                      
roshi                          	 roshi*                         	 rɑʃi                          
procrastinators                	 prəkræstənetərz                	 prəkræstənetərz               
roistered                      	 roistered*                     	 rɔɪstərd                      
baggage                        	 bægɪʤ                          	 bægɪʤ                         
silencing                      	 saɪlənsɪŋ                      	 saɪlənsɪŋ                     
styx                           	 stɪks                          	 stɪks                         
denote                         	 dɪnoʊt                         	 dɪnoʊt                        
twinning                       	 twinning*                      	 twɪnɪŋ                        
agarose                        	 agarose*                       	 ægəroʊs                       
naively                        	 nɑivli                         	 nɑivli                        
harps                          	 hɑrps                          	 hɑrps                         
anorexia                       	 ænərɛksiə                      	 ænərɛksiə                     
pandas                         	 pændəz                         	 pændəz                        
context                        	 kɑntɛkst                       	 kɑntɛkst                      
oldest                         	 oʊldəst                        	 oʊldəst                       
snakelike                      	 sneklaɪk                       	 sneklaɪk                      
duka                           	 duka*                          	 dukə                          
goddesses                      	 gɑdəsɪz                        	 gɑdəsɪz                       
anus                           	 enəs                           	 enəs                          
glamouring                     	 glamouring*                    	 glæmərɪŋ                      
majora                         	 majora*                        	 məʤɔrə                        
halo                           	 heloʊ                          	 heloʊ                         
foxhunt                        	 foxhunt*                       	 fɑksənt                       
reappear                       	 riəpɪr                         	 riəpɪr                        
ungenerous                     	 ungenerous*                    	 ənʤɛnərəs                     
masticatory                    	 masticatory*                   	 mæstɪkətɔri                   
secs                           	 secs*                          	 sɛks                          
hubby                          	 həbi                           	 həbi                          
contraindications              	 contraindications*             	 kɑntrəndɪkeʃənz               
sleuthing                      	 sluθɪŋ                         	 sluðɪŋ                        
misfit                         	 mɪsfɪt                         	 mɪsfɪt                        
petechial                      	 petechial*                     	 pətɛkiəl                      
galleta                        	 galleta*                       	 gæletə                        
breezing                       	 breezing*                      	 brizɪŋ                        
blazed                         	 blezd                          	 blezd                         
bulger                         	 bəlgər                         	 bəlʤər                        
presentations                  	 prɛzənteʃənz                   	 prɛzənteʃənz                  
syzygy                         	 syzygy*                        	 sɪzɪʤi                        
indoors                        	 ɪndɔrz                         	 ɪndɔrz                        
curies                         	 curies*                        	 kjʊriz                        
expos                          	 ɛkspoʊz                        	 ɛkspoʊ                        
grails                         	 grails*                        	 grelz                         
donne                          	 dən                            	 dən                           
stephen                        	 stivən                         	 stɛfən                        
hygiene                        	 haɪʤin                         	 haɪʤin                        
homeys                         	 homeys*                        	 hoʊmiz                        
overthink                      	 overthink*                     	 oʊvərθɪŋk                     
riskier                        	 rɪskiər                        	 rɪskiər                       
drivable                       	 draɪvəbəl                      	 draɪvəbəl                     
paganism                       	 pegənɪzəm                      	 pegənɪzəm                     
reacts                         	 riækts                         	 riækts                        
goose                          	 gus                            	 gus                           
ermined                        	 ermined*                       	 ərmənd                        
expletives                     	 ɛksplətɪvz                     	 ɛksplətɪvz                    
ballgown                       	 ballgown*                      	 bælgoʊn                       
identification                 	 aɪdɛntəfəkeʃən                 	 aɪdɛntəfəkeʃən                
pulverised                     	 pulverised*                    	 pʊlvəraɪzd                    
boniface                       	 boniface*                      	 bɑnəfəs                       
implanting                     	 ɪmplæntɪŋ                      	 ɪmplæntɪŋ                     
shift                          	 ʃɪft                           	 ʃɪft                          
surpass                        	 sərpæs                         	 sərpæs                        
sever                          	 sɛvər                          	 sɛvər                         
hellman                        	 hɛlmən                         	 hɛlmæn                        
fuehrer                        	 fuehrer*                       	 fjurər                        
calchas                        	 calchas*                       	 kælkəz                        
derk                           	 dərk                           	 dərk                          
flaxseed                       	 flæksid                        	 flæksid                       
shades                         	 ʃedz                           	 ʃedz                          
greening                       	 grinɪŋ                         	 grinɪŋ                        
commendation                   	 kɑməndeʃən                     	 kɑməndeʃən                    
demoralizing                   	 dɪmɔrəlaɪzɪŋ                   	 dɪmɔrəlɪzɪŋ                   
openings                       	 oʊpənɪŋz                       	 oʊpənɪŋz                      
insofar                        	 ɪnsəfɑr                        	 ɪnsəfɑr                       
scraped                        	 skrept                         	 skrept                        
moisturising                   	 moisturising*                  	 mɔɪsʧərɪsɪŋ                   
marjorie                       	 mɑrʤəri                        	 mɑrʤəri                       
compartmentalize               	 kəmpɑrtmɛntəlaɪz               	 kɑmpərtmɛnəlz                 
privation                      	 praɪveʃən                      	 praɪveʃən                     
tetragrammaton                 	 tetragrammaton*                	 tɛtrəgræmətən                 
speer                          	 spɪr                           	 spɪr                          
impalement                     	 impalement*                    	 ɪmpelmənt                     
romantically                   	 roʊmæntɪkəli                   	 roʊmæntɪkəli                  
cloistered                     	 klɔɪstərd                      	 klɔɪstərd                     
glares                         	 glɛrz                          	 glɛrz                         
repeated                       	 rɪpitɪd                        	 rɪpitɪd                       
doorway                        	 dɔrwe                          	 dɔrwe                         
renomination                   	 rinɑməneʃən                    	 rɪnɑməneʃən                   
carson                         	 kɑrzən                         	 kɑrsən                        
virology                       	 vɪrɑləʤi                       	 vɪrɑləʤi                      
cathartically                  	 cathartically*                 	 kəθɑrtɪkəli                   
moonlighting                   	 munlaɪtɪŋ                      	 munlaɪtɪŋ                     
unfreezes                      	 unfreezes*                     	 ənfrizɪz                      
brats                          	 bræts                          	 bræts                         
rectification                  	 rɛktəfəkeʃən                   	 rɛktəfəkeʃən                  
simulator                      	 sɪmjəletər                     	 sɪmjəletər                    
billion                        	 bɪljən                         	 bɪljən                        
scarring                       	 skɑrɪŋ                         	 skɑrɪŋ                        
swamping                       	 swɑmpɪŋ                        	 swɑmpɪŋ                       
handcuff                       	 hændkəf                        	 hændkəf                       
reckon                         	 rɛkən                          	 rɛkən                         
reenlisting                    	 reenlisting*                   	 rinlɪstɪŋ                     
stanford                       	 stænfərd                       	 stænfɔrd                      
emotionalism                   	 imoʊʃnəlɪzəm                   	 imoʊʃnəlɪzəm                  
execution                      	 ɛksəkjuʃən                     	 ɛksəkjuʃən                    
demons                         	 dimənz                         	 dimənz                        
chicane                        	 chicane*                       	 ʃɪken                         
fugue                          	 fjug                           	 fjug                          
reliability                    	 rilaɪəbɪləti                   	 rilaɪəbɪləti                  
perceives                      	 pərsivz                        	 pərsivz                       
euros                          	 juroʊz                         	 jʊrɑs                         
adverb                         	 ædvərb                         	 ædvərb                        
calculators                    	 kælkjəletərz                   	 kælkjəletərz                  
franchising                    	 frænʧaɪzɪŋ                     	 frænʧaɪzɪŋ                    
dilantin                       	 dilantin*                      	 daɪlæntɪn                     
lip                            	 lɪp                            	 lɪp                           
banding                        	 bændɪŋ                         	 bændɪŋ                        
zirconia                       	 zirconia*                      	 zərkoʊniə                     
lemming                        	 lɛmɪŋ                          	 lɛmɪŋ                         
gradually                      	 græʤuəli                       	 græʤuəli                      
flawlessly                     	 flɔləsli                       	 flɔləsli                      
extremes                       	 ɪkstrimz                       	 ɪkstrimz                      
blowup                         	 bloʊəp                         	 bloʊəp                        
church                         	 ʧərʧ                           	 ʧərʧ                          
tickle                         	 tɪkəl                          	 tɪkəl                         
worcester                      	 wʊstər                         	 wərsɛstər                     
heliotrope                     	 hiliətroʊp                     	 hiliətroʊp                    
clerks                         	 klərks                         	 klərks                        
shop                           	 ʃɑp                            	 ʃɑp                           
cleft                          	 klɛft                          	 klɛft                         
nontraditional                 	 nɑntrədɪʃənəl                  	 nɑntrədɪʃənəl                 
rue                            	 ru                             	 ru                            
karuna                         	 karuna*                        	 kərunə                        
congest                        	 kənʤɛst                        	 kənʤɛst                       
capstone                       	 kæpstoʊn                       	 kæpstoʊn                      
craddy                         	 craddy*                        	 krædi                         
stinks                         	 stɪŋks                         	 stɪŋks                        
peds                           	 peds*                          	 pɛdz                          
anoscopy                       	 anoscopy*                      	 ænɔskɑpi                      
conferring                     	 kənfərɪŋ                       	 kənfərɪŋ                      
yerba                          	 yerba*                         	 jərbə                         
duelling                       	 duelling*                      	 duəlɪŋ                        
latching                       	 læʧɪŋ                          	 læʧɪŋ                         
spectre                        	 spɛktər                        	 spɛktrə                       
publican                       	 publican*                      	 pəblɪkən                      
corrections                    	 kərɛkʃənz                      	 kərɛkʃənz                     
foo                            	 fu                             	 fu                            
modulates                      	 modulates*                     	 mɔʤulets                      
endemic                        	 ɛndɛmɪk                        	 ɛndɛmɪk                       
allspice                       	 ɔlspaɪs                        	 ɔlspaɪs                       
boutiques                      	 butiks                         	 butiks                        
grievous                       	 grivəs                         	 grivəs                        
dovetails                      	 dəvtelz                        	 dəvtelz                       
deformed                       	 dɪfɔrmd                        	 dɪfɔrmd                       
propagates                     	 propagates*                    	 prɑpəgets                     
curt                           	 kərt                           	 kərt                          
hallucinations                 	 həlusəneʃənz                   	 həlusəneʃənz                  
mallard                        	 mælərd                         	 mælərd                        
arbour                         	 ɑrbər                          	 ɑrbər                         
distended                      	 dɪstɛndɪd                      	 dɪstɛndɪd                     
illicit                        	 ɪlɪsət                         	 ɪlɪsət                        
signboard                      	 signboard*                     	 sɪgnoʊɔrd                     
bucolic                        	 bjukɑlɪk                       	 bjukɑlɪk                      
yeses                          	 jɛsɪz                          	 jɛsɪz                         
salacious                      	 səleʃəs                        	 səleʃəs                       
depressants                    	 dɪprɛsənts                     	 dɪprɛsənts                    
sentimentalists                	 sentimentalists*               	 sɛnəmɛnəlɪsts                 
keystrokes                     	 kistroʊks                      	 kistroʊks                     
dissimulate                    	 dissimulate*                   	 dɪsɪmjəlet                    
myxedema                       	 myxedema*                      	 mɪksidmə                      
crucify                        	 krusəfaɪ                       	 krusəfaɪ                      
vanities                       	 vænətiz                        	 vænətiz                       
unmotivated                    	 unmotivated*                   	 ənmoʊtəvetɪd                  
encumbrance                    	 encumbrance*                   	 ɪnkəmbrəns                    
sis                            	 sɪs                            	 sɪs                           
adventurous                    	 ædvɛnʧərəs                     	 ædvɛnʧərəs                    
en                             	 ɛn                             	 ɛn                            
storytelling                   	 stɔritɛlɪŋ                     	 stɔritɛlɪŋ                    
sealskin                       	 sealskin*                      	 silskɪn                       
giftwrap                       	 giftwrap*                      	 gɪftræp                       
unrung                         	 unrung*                        	 ənrəŋ                         
befuddled                      	 bɪfədəld                       	 bɪfədəld                      
corpuses                       	 corpuses*                      	 kɔrpəsɪz                      
escuela                        	 escuela*                       	 ɛskjuələ                      
bloodhounds                    	 blədhaʊnz                      	 blədhaʊndz                    
used                           	 juzd                           	 juzd                          
lags                           	 lægz                           	 lægz                          
strung                         	 strəŋ                          	 strəŋ                         
pesos                          	 pesoʊz                         	 pisoʊz                        
foiled                         	 fɔɪld                          	 fɔɪld                         
bellyache                      	 bɛliek                         	 bɛljəʧ                        
roubles                        	 roubles*                       	 rubəlz                        
ejaculator                     	 ejaculator*                    	 əʤækjəletər                   
cyclopedia                     	 cyclopedia*                    	 saɪkləpidiə                   
redrew                         	 redrew*                        	 ridru                         
diphthongs                     	 diphthongs*                    	 dɪfθɔŋz                       
deficits                       	 dɛfɪsɪts                       	 dɛfɪsɪts                      
welfare                        	 wɛlfɛr                         	 wɛlfɛr                        
ambushing                      	 æmbʊʃɪŋ                        	 æmbʊʃɪŋ                       
florentine                     	 flɔrəntin                      	 flɔrəntaɪn                    
arbiter                        	 ɑrbɪtər                        	 ɑrbɪtər                       
patriarchs                     	 petriɑrks                      	 petriɑrks                     
plasticizer                    	 plæstəsaɪzər                   	 plæstɪsaɪzər                  
zambia                         	 zæmbiə                         	 zæmbiə                        
errantly                       	 errantly*                      	 ɛrəntli                       
elastic                        	 ɪlæstɪk                        	 ɪlæstɪk                       
acreage                        	 ekərɪʤ                         	 ekərɪʤ                        
far                            	 fɑr                            	 fɑr                           
sesquipedalian                 	 sesquipedalian*                	 sɛskwəpaɪpdliən               
osculation                     	 osculation*                    	 ɑskjəleʃən                    
shotgunned                     	 shotgunned*                    	 ʃɑtgənd                       
passably                       	 pæsəbli                        	 pæsəbli                       
trinitrate                     	 trinitrate*                    	 trɪnɪtret                     
camions                        	 camions*                       	 kæmiənz                       
marvellously                   	 marvellously*                  	 mɑrvələsli                    
waiver                         	 wevər                          	 wevər                         
ut                             	 ut*                            	 ət                            
zoroastrianism                 	 zoroastrianism*                	 zoʊroʊæstriənɪzəm             
annexe                         	 annexe*                        	 ænɛks                         
assigning                      	 əsaɪnɪŋ                        	 əsaɪnɪŋ                       
possess                        	 pəzɛs                          	 pəzɛs                         
pleading                       	 plidɪŋ                         	 plidɪŋ                        
stiffing                       	 stiffing*                      	 stɪfɪŋ                        
truncheons                     	 trənʧɪnz                       	 trənʧɪnz                      
principia                      	 prɪnsɪpiə                      	 prɪnsɪpiə                     
partition                      	 pɑrtɪʃən                       	 pɑrtɪʃən                      
ng                             	 ɪŋ                             	 ng                            
agitprop                       	 æʤətprɔp                       	 æʤətprɔp                      
renouncing                     	 rɪnaʊnsɪŋ                      	 rɪnaʊnsɪŋ                     
polarities                     	 polarities*                    	 poʊlɛrətiz                    
doles                          	 doʊlz                          	 doʊlz                         
hatbox                         	 hatbox*                        	 hætbɑks                       
lamented                       	 ləmɛntɪd                       	 ləmɛntɪd                      
cabooses                       	 kəbusɪz                        	 kəbusɪz                       
flowerpots                     	 flowerpots*                    	 flaʊərpɑts                    
sloan                          	 sloʊn                          	 sloʊn                         
enlivens                       	 ɛnlaɪvənz                      	 ɛnlɪvənz                      
destroy                        	 dɪstrɔɪ                        	 dɪstrɔɪ                       
pondered                       	 pɑndərd                        	 pɑndərd                       
reactive                       	 riæktɪv                        	 riæktɪv                       
lactating                      	 læktetɪŋ                       	 læktetɪŋ                      
lingonberry                    	 lingonberry*                   	 lɪŋgənbɛri                    
scrotum                        	 scrotum*                       	 skrɑtəm                       
czardas                        	 czardas*                       	 zɑrdəz                        
glistens                       	 glistens*                      	 glɪsənz                       
savings                        	 sevɪŋz                         	 sevɪŋz                        
undertones                     	 əndərtoʊnz                     	 əndərtoʊnz                    
shave                          	 ʃev                            	 ʃev                           
actuarial                      	 ækʧuɛriəl                      	 ækʧuɛriəl                     
conveyed                       	 kənved                         	 kənved                        
rumania                        	 rumeniə                        	 rumeniə                       
cruel                          	 kruəl                          	 kruəl                         
tachometer                     	 tachometer*                    	 tækoʊmɛtər                    
savannah                       	 səvænə                         	 səvænə                        
dally                          	 dæli                           	 dæli                          
pools                          	 pulz                           	 pulz                          
awnings                        	 awnings*                       	 ɑnɪŋz                         
awesomely                      	 ɔsəmli                         	 ɔsəmli                        
superheat                      	 superheat*                     	 supərhit                      
alliteration                   	 əlɪtəreʃən                     	 əlɪtəreʃən                    
derecho                        	 derecho*                       	 dɪrɛkoʊ                       
gastrointestinal               	 gæstroʊɪntɛstənəl              	 gæstrɔɪntəntɪl                
evitable                       	 evitable*                      	 ɛvətəbəl                      
amiable                        	 emiəbəl                        	 emiəbəl                       
serge                          	 sərʤ                           	 sərʤ                          
flooding                       	 flədɪŋ                         	 flədɪŋ                        
friend                         	 frɛnd                          	 frɛnd                         
scags                          	 skægz                          	 skægz                         
restore                        	 rɪstɔr                         	 rɪstɔr                        
cribs                          	 krɪbz                          	 krɪbz                         
cuss                           	 kəs                            	 kəs                           
rumrunners                     	 rumrunners*                    	 rəmənərz                      
hirelings                      	 hirelings*                     	 haɪərlɪŋz                     
crepes                         	 kreps                          	 krips                         
biopsied                       	 biopsied*                      	 baɪɑpsid                      
maire                          	 mɛr                            	 mɛr                           
moderator                      	 mɑdəretər                      	 mɑdəretər                     
rowdier                        	 rowdier*                       	 raʊdiər                       
artlessly                      	 artlessly*                     	 ɑrtləsli                      
rageful                        	 rageful*                       	 reʤfəl                        
condoned                       	 kəndoʊnd                       	 kəndoʊnd                      
pilasters                      	 pəlæstərz                      	 pəlæstərz                     
vasopressin                    	 vasopressin*                   	 væzəprɛsən                    
attuned                        	 ətund                          	 ətund                         
trippingly                     	 trippingly*                    	 trɪpɪŋli                      
minutemen                      	 mɪnətmɛn                       	 mɪnətmən                      
drek                           	 drek*                          	 drɛk                          
drain                          	 dren                           	 dren                          
cleaving                       	 cleaving*                      	 klivɪŋ                        
phantoms                       	 fænəmz                         	 fænəmz                        
underappreciated               	 underappreciated*              	 əndəræprietɪd                 
emits                          	 ɪmɪts                          	 ɪmɪts                         
pac                            	 pæk                            	 pæk                           
swedes                         	 swidz                          	 swidz                         
extincted                      	 extincted*                     	 ɪkstɪŋktɪd                    
mikvah                         	 mikvah*                        	 mɪkhə                         
whisperer                      	 wɪspərər                       	 wɪspərər                      
finishers                      	 fɪnɪʃərz                       	 fɪnɪʃərz                      
stipend                        	 staɪpənd                       	 staɪpɛnd                      
exercises                      	 ɛksərsaɪzɪz                    	 ɛksərsaɪzɪz                   
frogfish                       	 frogfish*                      	 frɑgfɪʃ                       
tollhouse                      	 tollhouse*                     	 tɑlhaʊs                       
bloater                        	 bloater*                       	 bloʊtər                       
plumber                        	 pləmər                         	 pləmər                        
jokester                       	 ʤoʊkstər                       	 ʤoʊkstər                      
entryway                       	 ɛntriwe                        	 ɛntriwe                       
glandular                      	 glænʤələr                      	 glænʤələr                     
erroneous                      	 ɛroʊniəs                       	 ɛroʊniəs                      
rigidly                        	 rɪʤɪdli                        	 rɪʤɪdli                       
percheron                      	 percheron*                     	 pərʧərən                      
obsidian                       	 əbsɪdiən                       	 əbsɪdiən                      
dazzling                       	 dæzəlɪŋ                        	 dæzəlɪŋ                       
dit                            	 dit*                           	 dɪt                           
engulf                         	 ɪngəlf                         	 ɪngəlf                        
finest                         	 faɪnəst                        	 faɪnəst                       
briefcase                      	 brifkes                        	 brifkes                       
verbose                        	 verbose*                       	 vərboʊs                       
dukedom                        	 dukdəm                         	 dukdəm                        
chooser                        	 chooser*                       	 ʧuzər                         
constellation                  	 kɑnstəleʃən                    	 kɑnstəleʃən                   
feller                         	 fɛlər                          	 fɛlər                         
snowplow                       	 snoʊplaʊ                       	 snoʊploʊ                      
radiations                     	 radiations*                    	 redieʃənz                     
chophouses                     	 chophouses*                    	 ʧɑfəsəz                       
swifts                         	 swɪfts                         	 swɪfts                        
allocate                       	 æləket                         	 æləket                        
tovarisch                      	 tovarisch*                     	 toʊvərɪs                      
overexcitement                 	 overexcitement*                	 oʊvərɪksaɪtmənt               
ruination                      	 ruination*                     	 ruɪneʃən                      
weighing                       	 weɪŋ                           	 weɪŋ                          
sinky                          	 sinky*                         	 sɪŋki                         
dp                             	 dp*                            	 dpɑp                          
mandated                       	 mændetɪd                       	 mændetɪd                      
bink                           	 bɪŋk                           	 bɪŋk                          
ecosystems                     	 ikoʊsɪstəmz                    	 ikoʊsɪstəmz                   
standings                      	 stændɪŋz                       	 stændɪŋz                      
feedy                          	 feedy*                         	 fidi                          
skiddooed                      	 skiddooed*                     	 skɪdud                        
appetiser                      	 appetiser*                     	 əpɛtɪzər                      
thrifts                        	 θrɪfts                         	 θrɪfts                        
casualness                     	 kæʒəwəlnɛs                     	 kæʒəwəlnɛs                    
sunnier                        	 sunnier*                       	 səniər                        
convolutions                   	 convolutions*                  	 kɑnvəluʃənz                   
vireo                          	 vireo*                         	 vɪrioʊ                        
drover                         	 droʊvər                        	 droʊvər                       
churro                         	 churro*                        	 ʧəroʊ                         
glommed                        	 glommed*                       	 glɑmd                         
aromatic                       	 ɛrəmætɪk                       	 ɛrəmætɪk                      
reservoirs                     	 rɛzərvwɑrz                     	 rɛzərvwɑrz                    
canfield                       	 kænfild                        	 kænfild                       
knights                        	 naɪts                          	 naɪts                         
proactive                      	 proʊæktɪv                      	 proʊæktɪv                     
until                          	 əntɪl                          	 əntɪl                         
straddling                     	 strædlɪŋ                       	 strædəlɪŋ                     
spews                          	 spjuz                          	 spjuz                         
sundowning                     	 sundowning*                    	 səndaʊnɪŋ                     
alarums                        	 alarums*                       	 ælərəmz                       
pioneers                       	 paɪənɪrz                       	 paɪənɪrz                      
gendarmerie                    	 gendarmerie*                   	 ʤɛndərmɛri                    
sweetheart                     	 swithɑrt                       	 swithɑrt                      
avoidance                      	 əvɔɪdəns                       	 əvɔɪdəns                      
puffed                         	 pəft                           	 pəft                          
blundering                     	 bləndərɪŋ                      	 bləndərɪŋ                     
sidestep                       	 saɪdstɛp                       	 saɪdstɛp                      
freshmen                       	 frɛʃmɪn                        	 frɛʃmɪn                       
ostracize                      	 ɔstrəsaɪz                      	 ɑstrəsaɪz                     
ermines                        	 ermines*                       	 ərmənz                        
pinecone                       	 pinecone*                      	 paɪnkoʊn                      
embezzler                      	 ɪmbɛzələr                      	 ɪmbɛzələr                     
scroungy                       	 scroungy*                      	 skraʊnʤi                      
portability                    	 pɔrtəbɪlɪti                    	 pɔrtəbɪlɪti                   
observers                      	 əbzərvərz                      	 əbzərvərz                     
idiocy                         	 ɪdiəsi                         	 ɪdiəsi                        
intimately                     	 ɪntɪmətli                      	 ɪntɪmətli                     
heresies                       	 heresies*                      	 hɛrəsiz                       
lionize                        	 laɪənaɪz                       	 laɪənaɪz                      
dampness                       	 dæmpnɪs                        	 dæmpnɪs                       
strewth                        	 strewth*                       	 struθ                         
posses                         	 pɑsiz                          	 pɑsɪz                         
pepper                         	 pɛpər                          	 pɛpər                         
adjudicating                   	 əʤudɪketɪŋ                     	 əʤudɪketɪŋ                    
dolomite                       	 doʊləmaɪt                      	 doʊləmaɪt                     
gigahertz                      	 gigahertz*                     	 gɪgəhərts                     
salivate                       	 sæləvet                        	 sæləvet                       
unbalanced                     	 ənbælənst                      	 ənbælənst                     
churned                        	 ʧərnd                          	 ʧərnd                         
puddings                       	 pʊdɪŋz                         	 pʊdɪŋz                        
juniors                        	 ʤunjərz                        	 ʤunjərz                       
street                         	 strit                          	 strit                         
ungallant                      	 ungallant*                     	 əngælənt                      
apostrophe                     	 əpɑstrəfi                      	 əpɑstrəfi                     
plan                           	 plæn                           	 plæn                          
rudeness                       	 rudnəs                         	 rudnəs                        
impotent                       	 ɪmpətənt                       	 ɪmpətənt                      
inspects                       	 ɪnspɛkts                       	 ɪnspɛkts                      
streptomycin                   	 streptomycin*                  	 strɛptəmɪsɪn                  
vastness                       	 væstnəs                        	 væstnəs                       
unsaddle                       	 unsaddle*                      	 ənsædəl                       
benched                        	 benched*                       	 bɛnʧt                         
bookman                        	 bʊkmən                         	 bʊkmən                        
negatory                       	 negatory*                      	 nɛgətɔri                      
logged                         	 lɔgd                           	 lɔgd                          
sustaining                     	 səstenɪŋ                       	 səstenɪŋ                      
kayaks                         	 kaɪæks                         	 kaɪæks                        
loosen                         	 lusən                          	 lusən                         
torus                          	 torus*                         	 tɔrəs                         
funfair                        	 funfair*                       	 fənfɛr                        
bk                             	 bk*                            	 bɑk                           
hertfordshire                  	 hertfordshire*                 	 hərtfɔrdʃaɪr                  
pendulous                      	 pɛnʤələs                       	 pɛnʤələs                      
resemblance                    	 rɪzɛmbləns                     	 rɪzɛmbləns                    
cabmen                         	 cabmen*                        	 kæbmən                        
mar                            	 mɑr                            	 mɑr                           
painstaking                    	 penstekɪŋ                      	 penstekɪŋ                     
avionics                       	 eviɑnɪks                       	 eviɑnɪks                      
aesthete                       	 ɛsθit                          	 ɛsθit                         
mistook                        	 mɪstʊk                         	 mɪstʊk                        
derringers                     	 derringers*                    	 dɛrɪŋərz                      
legalistic                     	 lɛgəlɪstɪk                     	 lɛgəlɪstɪk                    
firs                           	 fərz                           	 fərz                          
crate                          	 kret                           	 kret                          
closers                        	 closers*                       	 kloʊzərz                      
transillumination              	 trænzəluməneʃən                	 trænzəluməneʃən               
mask                           	 mæsk                           	 mæsk                          
fleshly                        	 fleshly*                       	 flɛʃli                        
crippingly                     	 crippingly*                    	 krɪpɪŋli                      
unloading                      	 ənloʊdɪŋ                       	 ənloʊdɪŋ                      
transmute                      	 transmute*                     	 trænsmut                      
quadrant                       	 kwɑdrənt                       	 kwɑdrənt                      
harle                          	 hɑrəl                          	 hɑrlə                         
originating                    	 ərɪʤənetɪŋ                     	 ərɪʤənetɪŋ                    
huppahs                        	 huppahs*                       	 həpəhəz                       
globalization                  	 gloʊbəlɪzeʃən                  	 gloʊbælɪzeʃən                 
harridans                      	 harridans*                     	 hɛrɪdənz                      
recoverable                    	 rɪkəvərəbəl                    	 rɪkəvərəbəl                   
forsee                         	 fərsi                          	 fɔrsi                         
sociology                      	 soʊsiɑləʤi                     	 soʊsiɑləʤi                    
holily                         	 holily*                        	 hɑləli                        
orthoepy                       	 orthoepy*                      	 ɔrθiɛpi                       
anuran                         	 anuran*                        	 ænjʊrən                       
tamaracks                      	 tamaracks*                     	 tæməræks                      
anchormen                      	 æŋkərmɛn                       	 ænʧɔrmən                      
recurs                         	 recurs*                        	 rikərz                        
liquifying                     	 liquifying*                    	 lɪkwəfaɪɪŋ                    
opaque                         	 oʊpek                          	 oʊpek                         
agitating                      	 æʤətetɪŋ                       	 æʤətetɪŋ                      
paydays                        	 paydays*                       	 pedez                         
flowcharting                   	 flowcharting*                  	 floʊʧɑrtɪŋ                    
artists                        	 ɑrtɪsts                        	 ɑrtɪsts                       
min                            	 mɪn                            	 mɪn                           
mansions                       	 mænʧənz                        	 mænʧənz                       
uncivil                        	 ənsɪvəl                        	 ənsɪvəl                       
fiddlers                       	 fɪdələrz                       	 fɪdələrz                      
caplin                         	 kæplɪn                         	 kæplɪn                        
euphony                        	 jufəni                         	 jufəni                        
cords                          	 kɔrdz                          	 kɔrdz                         
kep                            	 kep*                           	 kɛp                           
nonetheless                    	 nənðəlɛs                       	 nɑnəθɛləs                     
unquestionably                 	 ənkwɛsʧənəbli                  	 ənkwɛsʧənəbli                 
exposes                        	 ɪkspoʊzɪz                      	 ɪkspoʊzɪz                     
intact                         	 ɪntækt                         	 ɪntækt                        
thalers                        	 thalers*                       	 ðelərz                        
leda                           	 lidə                           	 lidə                          
piratical                      	 piratical*                     	 pɪrətɪkəl                     
provably                       	 provably*                      	 pruvəbli                      
remixes                        	 remixes*                       	 rimɪksɪz                      
throwing                       	 θroʊɪŋ                         	 θroʊɪŋ                        
flat                           	 flæt                           	 flæt                          
unprecedented                  	 ənprɛsɪdɛntɪd                  	 ənprɛsɪdɛntɪd                 
nudes                          	 nudz                           	 nudz                          

 
 No IPA translation using library: 330 (33.0%) 
IPA translation that is the same using the library and model: 595 (88.80597014925374%) 
SED Average Including when SED is 0: 142/670 (0.21194029850746268) 
SED Average Excluding when SED is 0: 142/75 (1.8933333333333333) 

 
 Words that have different IPA Transcriptions 
cadillac                       	 kædəlæk                        	 kædɪlæk                        	 String Edit Distance 1  
runaways                       	 rənəwez                        	 runəwez                        	 String Edit Distance 1  
pumice                         	 pəməs                          	 pjumɪs                         	 String Edit Distance 3  
triceratops                    	 traɪsɛrətɔps                   	 trɪsəretəps                    	 String Edit Distance 4  
combust                        	 kəmbəst                        	 kɑmbəst                        	 String Edit Distance 1  
ironsides                      	 aɪərnsaɪdz                     	 aɪrənsaɪdz                     	 String Edit Distance 1  
center                         	 sɛnər                          	 sɛntər                         	 String Edit Distance 1  
boomtown                       	 bumtaʊn                        	 bumtoʊn                        	 String Edit Distance 1  
clos                           	 klɑs                           	 kloʊs                          	 String Edit Distance 2  
carrell                        	 kɑrel                          	 kærɛl                          	 String Edit Distance 2  
fulani                         	 fulɑni                         	 fəleni                         	 String Edit Distance 2  
psychogenic                    	 saɪkoʊʤɛnɪk                    	 saɪkəʤɛnɪk                     	 String Edit Distance 2  
banbury                        	 bænbɛri                        	 bænbjəri                       	 String Edit Distance 2  
paramecium                     	 pɛrəmisiəm                     	 pɛrəmɛʃəm                      	 String Edit Distance 3  
nonrestricted                  	 nɑnrɪstrɪktɪd                  	 nɑnristrɪktɪd                  	 String Edit Distance 1  
tertius                        	 tərʃjɪs                        	 tərʃəs                         	 String Edit Distance 2  
lupine                         	 lupaɪn                         	 lupən                          	 String Edit Distance 2  
stravinsky                     	 strəvɪnski                     	 strævənski                     	 String Edit Distance 2  
laryngoscope                   	 lɑrɪnʤəskoʊp                   	 lɑrɪŋgoʊp                      	 String Edit Distance 5  
phillippi                      	 fəlipi                         	 fɪlɪpi                         	 String Edit Distance 2  
suez                           	 suɛz                           	 suz                            	 String Edit Distance 1  
vivacious                      	 vəveʃəs                        	 vɪveʃəs                        	 String Edit Distance 1  
scrutinizing                   	 skrutənaɪzɪŋ                   	 skrutinɪŋ                      	 String Edit Distance 4  
multivitamin                   	 məltivaɪtəmən                  	 məltɪvətəmən                   	 String Edit Distance 3  
huron                          	 hjʊrɑn                         	 hjʊrən                         	 String Edit Distance 1  
narcos                         	 nɑrkoʊs                        	 nɑrkoʊz                        	 String Edit Distance 1  
surpluses                      	 sərpləsɪz                      	 sərplusɪz                      	 String Edit Distance 1  
carriage                       	 kɛrəʤ                          	 kɛrɪʤ                          	 String Edit Distance 1  
defenseless                    	 dɪfɛnsləs                      	 dɪfɛnslɪs                      	 String Edit Distance 1  
triton                         	 traɪtən                        	 trɪtən                         	 String Edit Distance 1  
stivers                        	 staɪvərz                       	 stɪvərz                        	 String Edit Distance 1  
prioritized                    	 praɪɔrətaɪzd                   	 praɪərɪtəst                    	 String Edit Distance 6  
investiture                    	 ɪnvɛstəʧər                     	 ɪnvɛstətər                     	 String Edit Distance 1  
methotrexate                   	 mɛθoʊtrɛkset                   	 mɛθətrɛkset                    	 String Edit Distance 2  
valium                         	 væliəm                         	 væljəm                         	 String Edit Distance 1  
destabilization                	 distebələzeʃən                 	 distæbɪlɪzeʃən                 	 String Edit Distance 3  
woodbury                       	 wʊdbɛri                        	 wʊdbjəri                       	 String Edit Distance 2  
portico                        	 pɔrtəkoʊ                       	 pɔrtɪkoʊ                       	 String Edit Distance 1  
halas                          	 hɑləz                          	 heləz                          	 String Edit Distance 1  
donald                         	 dɑnəld                         	 doʊnəld                        	 String Edit Distance 2  
winningest                     	 wɪnɪŋəst                       	 wɪnɪnɪŋ                        	 String Edit Distance 4  
nationalization                	 næʃənələzeʃən                  	 næʃənəlaɪzeʃən                 	 String Edit Distance 2  
sleuthing                      	 sluθɪŋ                         	 sluðɪŋ                         	 String Edit Distance 1  
bulger                         	 bəlgər                         	 bəlʤər                         	 String Edit Distance 1  
expos                          	 ɛkspoʊz                        	 ɛkspoʊ                         	 String Edit Distance 1  
stephen                        	 stivən                         	 stɛfən                         	 String Edit Distance 2  
hellman                        	 hɛlmən                         	 hɛlmæn                         	 String Edit Distance 1  
demoralizing                   	 dɪmɔrəlaɪzɪŋ                   	 dɪmɔrəlɪzɪŋ                    	 String Edit Distance 1  
compartmentalize               	 kəmpɑrtmɛntəlaɪz               	 kɑmpərtmɛnəlz                  	 String Edit Distance 5  
renomination                   	 rinɑməneʃən                    	 rɪnɑməneʃən                    	 String Edit Distance 1  
carson                         	 kɑrzən                         	 kɑrsən                         	 String Edit Distance 1  
stanford                       	 stænfərd                       	 stænfɔrd                       	 String Edit Distance 1  
euros                          	 juroʊz                         	 jʊrɑs                          	 String Edit Distance 4  
worcester                      	 wʊstər                         	 wərsɛstər                      	 String Edit Distance 4  
spectre                        	 spɛktər                        	 spɛktrə                        	 String Edit Distance 1  
bloodhounds                    	 blədhaʊnz                      	 blədhaʊndz                     	 String Edit Distance 1  
pesos                          	 pesoʊz                         	 pisoʊz                         	 String Edit Distance 1  
bellyache                      	 bɛliek                         	 bɛljəʧ                         	 String Edit Distance 3  
florentine                     	 flɔrəntin                      	 flɔrəntaɪn                     	 String Edit Distance 2  
plasticizer                    	 plæstəsaɪzər                   	 plæstɪsaɪzər                   	 String Edit Distance 1  
ng                             	 ɪŋ                             	 ng                             	 String Edit Distance 2  
enlivens                       	 ɛnlaɪvənz                      	 ɛnlɪvənz                       	 String Edit Distance 1  
gastrointestinal               	 gæstroʊɪntɛstənəl              	 gæstrɔɪntəntɪl                 	 String Edit Distance 7  
crepes                         	 kreps                          	 krips                          	 String Edit Distance 1  
minutemen                      	 mɪnətmɛn                       	 mɪnətmən                       	 String Edit Distance 1  
stipend                        	 staɪpənd                       	 staɪpɛnd                       	 String Edit Distance 1  
snowplow                       	 snoʊplaʊ                       	 snoʊploʊ                       	 String Edit Distance 1  
straddling                     	 strædlɪŋ                       	 strædəlɪŋ                      	 String Edit Distance 1  
ostracize                      	 ɔstrəsaɪz                      	 ɑstrəsaɪz                      	 String Edit Distance 1  
posses                         	 pɑsiz                          	 pɑsɪz                          	 String Edit Distance 1  
harle                          	 hɑrəl                          	 hɑrlə                          	 String Edit Distance 1  
globalization                  	 gloʊbəlɪzeʃən                  	 gloʊbælɪzeʃən                  	 String Edit Distance 1  
forsee                         	 fərsi                          	 fɔrsi                          	 String Edit Distance 1  
anchormen                      	 æŋkərmɛn                       	 ænʧɔrmən                       	 String Edit Distance 4  
nonetheless                    	 nənðəlɛs                       	 nɑnəθɛləs                      	 String Edit Distance 5  
