word                           	 ipa                            	 ipa_model                      
availability                   	 əveləbɪlɪti                    	 əveləbɪlɪti                   
commodores                     	 commodores*                    	 kɑmədɔrz                      
genetic                        	 ʤənɛtɪk                        	 ʤənɛtɪk                       
metamorphoses                  	 metamorphoses*                 	 mɛtəmɔrfoʊzɪz                 
slouchy                        	 slouchy*                       	 slaʊʧi                        
cobblestones                   	 kɑbəlstoʊnz                    	 kɑbəlstoʊnz                   
jocular                        	 ʤɑkjələr                       	 ʤɑkjələr                      
gummed                         	 gəmd                           	 gəmd                          
enoch                          	 inək                           	 ɪnɑk                          
discover                       	 dɪskəvər                       	 dɪskəvər                      
coupon                         	 kupɔn                          	 kupɔn                         
immemorial                     	 ɪməmɔriəl                      	 ɪməmɔriəl                     
embankments                    	 ɛmbæŋkmənts                    	 ɛmbæŋkmənts                   
chateaux                       	 ʃətoʊ                          	 ʧetoʊ                         
sums                           	 səmz                           	 səmz                          
unanticipated                  	 ənæntɪsəpetɪd                  	 ənæntɪsəpetɪd                 
humiliates                     	 hjumɪliets                     	 hjumɪliets                    
mysteries                      	 mɪstəriz                       	 mɪstəriz                      
skirmish                       	 skərmɪʃ                        	 skərmɪʃ                       
constance                      	 kɑnstəns                       	 kɑnstəns                      
facetiae                       	 facetiae*                      	 fəsiʃiə                       
cloche                         	 cloche*                        	 kloʊʃ                         
bureaus                        	 bjʊroʊz                        	 bjʊroʊz                       
shoo                           	 ʃu                             	 ʃu                            
scala                          	 skɑlə                          	 skelə                         
colloquium                     	 kəloʊkwiəm                     	 kəloʊkwəm                     
compile                        	 kəmpaɪl                        	 kəmpaɪl                       
warrants                       	 wɔrənts                        	 wɔrənts                       
intercoms                      	 intercoms*                     	 ɪntərkɑmz                     
frittering                     	 frɪtərɪŋ                       	 frɪtərɪŋ                      
nonevent                       	 nɑnɪvɛnt                       	 nɑnəvənt                      
solely                         	 soʊəli                         	 soʊəli                        
divided                        	 dɪvaɪdɪd                       	 dɪvaɪdɪd                      
extortion                      	 ɛkstɔrʃən                      	 ɛkstɔrʃən                     
buckhorn                       	 bəkhɔrn                        	 bəkhɔrn                       
reverberated                   	 rɪvərbəretɪd                   	 rɪvərbəretɪd                  
scissors                       	 sɪzərz                         	 sɪzərz                        
moreover                       	 mɔroʊvər                       	 mɔroʊvər                      
cueing                         	 cueing*                        	 kjuɪŋ                         
thoracoscope                   	 thoracoscope*                  	 θɔrəkɑskoʊp                   
iconography                    	 aɪkənɑgrəfi                    	 aɪkənɑgrəfi                   
velour                         	 vɛlur                          	 vɛlur                         
ballo                          	 bæloʊ                          	 bæloʊ                         
hyping                         	 haɪpɪŋ                         	 haɪpɪŋ                        
arousing                       	 əraʊzɪŋ                        	 əraʊzɪŋ                       
intertwined                    	 ɪntərtwaɪnd                    	 ɪntərtwaɪnd                   
regurgitated                   	 regurgitated*                  	 rɪgərʤətetɪd                  
epsilon                        	 ɛpsəlɑn                        	 ɛpsəlɑn                       
poof                           	 puf                            	 puf                           
santos                         	 sæntoʊs                        	 sæntoʊz                       
tubocurarine                   	 tubocurarine*                  	 tubəkjʊrɛrin                  
crouched                       	 kraʊʧt                         	 kraʊʧt                        
preceptors                     	 preceptors*                    	 prəsɛptərz                    
picky                          	 pɪki                           	 pɪki                          
premiering                     	 prɛmɪrɪŋ                       	 prɛmɪrɪŋ                      
unspoiled                      	 ənspɔɪld                       	 ənspɔɪld                      
dirge                          	 dərʤ                           	 dərʤ                          
plagiarised                    	 plagiarised*                   	 plæʤərɪzd                     
trousers                       	 traʊzərz                       	 traʊzərz                      
rube                           	 rub                            	 rub                           
nippers                        	 nippers*                       	 nɪpərz                        
disproven                      	 dɪspruvɪn                      	 dɪspruvən                     
teleconference                 	 tɛləkɑnfrəns                   	 tɛləkɑnfrəns                  
rescuer                        	 rɛskjuər                       	 rɛskjuər                      
gree                           	 gree*                          	 gri                           
landscaper                     	 lændskepər                     	 lænskepər                     
efface                         	 ɪfes                           	 ɪfes                          
begs                           	 bɛgz                           	 bɛgz                          
fattish                        	 fattish*                       	 fætɪʃ                         
anesthesiologist               	 ænəsθiziɑləʤɪst                	 ænɪsθiʒiɑləʤɪst               
constitutionals                	 constitutionals*               	 kɑnstətuʃənəlz                
firma                          	 fərmə                          	 fərmə                         
noncancerous                   	 noncancerous*                  	 nɑnkænsərəs                   
only                           	 oʊnli                          	 oʊnli                         
statehouse                     	 stethaʊs                       	 stethaʊs                      
podiatric                      	 podiatric*                     	 poʊdiætrɪk                    
glorified                      	 glɔrəfaɪd                      	 glɔrəfaɪd                     
toxify                         	 toxify*                        	 tɑksəfaɪ                      
monsieurs                      	 məsjərz                        	 məsjərz                       
motivator                      	 moʊtəvetər                     	 moʊtəvetər                    
bloodbath                      	 blədbæθ                        	 blədbæθ                       
acupuncturists                 	 acupuncturists*                	 ækjəpəŋkʧərɪsts               
ink                            	 ɪŋk                            	 ɪŋk                           
pram                           	 pram*                          	 præm                          
schoolhouses                   	 schoolhouses*                  	 skulhaʊsəz                    
punishable                     	 pənɪʃəbəl                      	 pənɪʃəbəl                     
lows                           	 loʊz                           	 loʊz                          
randle                         	 rændəl                         	 rændəl                        
grindingly                     	 grindingly*                    	 graɪndɪŋli                    
kneeling                       	 nilɪŋ                          	 nilɪŋ                         
rosebush                       	 roʊzbʊʃ                        	 roʊzbʊʃ                       
circuses                       	 sərkəsəz                       	 sərkəsəz                      
scowl                          	 skaʊl                          	 skaʊl                         
consuls                        	 consuls*                       	 kɑnsəlz                       
countdown                      	 kaʊntdaʊn                      	 kaʊntdaʊn                     
hout                           	 haʊt                           	 haʊt                          
colliers                       	 kɑljərz                        	 kɑljərz                       
affirmatively                  	 əfərmətɪvli                    	 əfərmətɪvli                   
repart                         	 repart*                        	 ripɑrt                        
jag                            	 jag*                           	 ʤæg                           
gobbled                        	 gɑbəld                         	 gɑbəld                        
sixteen                        	 sɪkstin                        	 sɪkstin                       
gish                           	 ʤɪʃ                            	 gɪʃ                           
colombian                      	 kələmbiən                      	 kəlɑmbiən                     
houseful                       	 haʊsfəl                        	 haʊsfəl                       
sookie                         	 sookie*                        	 sʊki                          
mongoloid                      	 mɑŋgəlɔɪd                      	 mɑŋgəlɔɪd                     
enchantress                    	 enchantress*                   	 ɪnʧænəs                       
cordy                          	 kɔrdi                          	 kɔrdi                         
fisherboy                      	 fisherboy*                     	 fɪʃərbɔɪ                      
singleness                     	 singleness*                    	 sɪŋgəlnəs                     
spitefully                     	 spitefully*                    	 spaɪtfəli                     
murky                          	 mərki                          	 mərki                         
overmastering                  	 overmastering*                 	 oʊvərmæstərɪŋ                 
asmodeus                       	 æzmədeəs                       	 əsmoʊdəs                      
filiety                        	 filiety*                       	 fɪliəti                       
rejuvenate                     	 rɪʤuvənet                      	 rɪʤuvənet                     
speck                          	 spɛk                           	 spɛk                          
tristram                       	 trɪstrəm                       	 trɪstræm                      
storytellers                   	 stɔritɛlərz                    	 stɔritɛlərz                   
poltergeist                    	 poʊltərgaɪst                   	 poʊltərgaɪst                  
overtaxed                      	 oʊvərtækst                     	 oʊvərtækst                    
man                            	 mæn                            	 mæn                           
floatability                   	 floatability*                  	 floʊtəbɪlɪti                  
recitations                    	 rɛsɪteʃənz                     	 rɛsɪteʃənz                    
jackknives                     	 jackknives*                    	 ʤæknaɪvz                      
nameplate                      	 nemplet                        	 nemplet                       
reappraise                     	 riəprez                        	 riəprez                       
panels                         	 pænəlz                         	 pænəlz                        
koller                         	 kɑlər                          	 kɑlər                         
decrypting                     	 decrypting*                    	 dɪkrɪptɪŋ                     
repulsers                      	 repulsers*                     	 rɪpəlsərz                     
moonlighters                   	 moonlighters*                  	 munlaɪtərz                    
foaming                        	 foʊmɪŋ                         	 foʊmɪŋ                        
speakeasies                    	 speakeasies*                   	 spikiz                        
elect                          	 ɪlɛkt                          	 ɪlɛkt                         
metroliner                     	 metroliner*                    	 mɛtroʊlinər                   
misrepresents                  	 mɪsrɛprəzɛnts                  	 mɪsrɛprəzɛnts                 
bouquet                        	 buke                           	 buke                          
savile                         	 savile*                        	 sævəl                         
babies                         	 bebiz                          	 bebiz                         
oxyacetylene                   	 oxyacetylene*                  	 ɑksiəsɛtəlin                  
loving                         	 ləvɪŋ                          	 ləvɪŋ                         
raved                          	 revd                           	 revd                          
pawnshop                       	 pɔnʃɑp                         	 pɔnʃɑp                        
bondsmen                       	 bondsmen*                      	 bɑndzmɪn                      
hospitalisation                	 hospitalisation*               	 hɑspətæləseʃən                
skedge                         	 skedge*                        	 skɛʤ                          
islands                        	 aɪləndz                        	 aɪləndz                       
waybill                        	 waybill*                       	 webɪl                         
profiles                       	 proʊfaɪlz                      	 proʊfaɪlz                     
gruff                          	 grəf                           	 grəf                          
gutsy                          	 gətsi                          	 gətsi                         
fretful                        	 frɛtfəl                        	 frɛtfəl                       
skewed                         	 skjud                          	 skjud                         
pointed                        	 pɔɪntɪd                        	 pɔɪntɪd                       
liquidates                     	 lɪkwɪdets                      	 lɪkwɪdets                     
onliest                        	 onliest*                       	 ɔnliəst                       
hurriedly                      	 həridli                        	 həridli                       
greedy                         	 gridi                          	 gridi                         
slackers                       	 slækərz                        	 slækərz                       
sibilants                      	 sibilants*                     	 sɪbələnts                     
fecundated                     	 fecundated*                    	 fɛkəndetɪd                    
wager                          	 weʤər                          	 weʤər                         
targeted                       	 tɑrgətɪd                       	 tɑrgətɪd                      
fourscore                      	 fourscore*                     	 fɔrskɔr                       
orderlies                      	 orderlies*                     	 ɔrdərliz                      
efforts                        	 ɛfərts                         	 ɪfɔrts                        
chowder                        	 ʧaʊdər                         	 ʧaʊdər                        
pari                           	 pari*                          	 pɑri                          
gruyere                        	 gruyere*                       	 gruər                         
chronicler                     	 krɑnɪklər                      	 krɑnɪklər                     
dimply                         	 dimply*                        	 dɪmpli                        
mist                           	 mɪst                           	 mɪst                          
quarantines                    	 kwɔrəntinz                     	 kwɔrəntinz                    
primers                        	 praɪmərz                       	 praɪmərz                      
unruffable                     	 unruffable*                    	 ənrəfəbəl                     
amebas                         	 amebas*                        	 ɑmbəz                         
newfound                       	 nufaʊnd                        	 nufaʊnd                       
stewardship                    	 stuərdʃɪp                      	 stuərdʃɪp                     
dilated                        	 daɪletɪd                       	 daɪletɪd                      
finessed                       	 fɪnɛst                         	 faɪnɛst                       
guzzling                       	 gəzəlɪŋ                        	 gəzəlɪŋ                       
earmark                        	 ɪrmɑrk                         	 ɪrmɑrk                        
boreholes                      	 boreholes*                     	 bɔrhoʊlz                      
manger                         	 menʤər                         	 menʤər                        
carioca                        	 kɛrioʊkə                       	 kɛrioʊkə                      
biopsy                         	 baɪɑpsi                        	 baɪɑpsi                       
scumbags                       	 skəmbægz                       	 skəmbægz                      
mills                          	 mɪlz                           	 mɪlz                          
conjunctival                   	 conjunctival*                  	 kənʤəŋktɪvəl                  
illumination                   	 ɪluməneʃən                     	 ɪluməneʃən                    
reaganomics                    	 regənɑmɪks                     	 rigənɑmɪks                    
pers                           	 pərs                           	 pərz                          
droves                         	 droʊvz                         	 droʊvz                        
minicams                       	 minicams*                      	 mɪnɪkəmz                      
franchise                      	 frænʧaɪz                       	 frænʧaɪz                      
perky                          	 pərki                          	 pərki                         
squirreling                    	 squirreling*                   	 skwərəlɪŋ                     
oversleep                      	 oʊvərslip                      	 oʊvərslip                     
flattened                      	 flætənd                        	 flætənd                       
longshore                      	 lɔŋʃɔr                         	 lɔŋʃɔr                        
gores                          	 gɔrz                           	 gɔrz                          
blenched                       	 blenched*                      	 blɛnʧt                        
unleash                        	 ənliʃ                          	 ənliʃ                         
slacks                         	 slæks                          	 slæks                         
hedging                        	 hɛʤɪŋ                          	 hɛʤɪŋ                         
cager                          	 cager*                         	 keʤər                         
octillion                      	 ɑktɪljən                       	 ɔktɪljən                      
shade                          	 ʃed                            	 ʃed                           
paperclip                      	 paperclip*                     	 pepərklɪp                     
skewered                       	 skjuərd                        	 skjuərd                       
lumberman                      	 ləmbərmən                      	 ləmbərmən                     
springer                       	 sprɪŋər                        	 sprɪŋər                       
folderols                      	 folderols*                     	 fɑldəroʊlz                    
dreaming                       	 drimɪŋ                         	 drimɪŋ                        
headfirst                      	 hɛdfərst                       	 hɛdfərst                      
udders                         	 udders*                        	 ədərz                         
whenas                         	 whenas*                        	 winəz                         
frigid                         	 frɪʤəd                         	 frɪʤəd                        
photo                          	 foʊtoʊ                         	 foʊtoʊ                        
cunts                          	 cunts*                         	 kənts                         
frigging                       	 frɪgɪŋ                         	 frɪgɪŋ                        
fishnets                       	 fishnets*                      	 fɪʃnəts                       
nietzschean                    	 nietzschean*                   	 niɪtskin                      
protestation                   	 proʊtɛsteʃən                   	 proʊtɛsteʃən                  
barrier                        	 bɛriər                         	 bɛriər                        
pompoms                        	 pɑmpɑmz                        	 pɑmpəmz                       
cardholder                     	 kɑrdhoʊldər                    	 kɑrdhoʊldər                   
rivals                         	 raɪvəlz                        	 raɪvəlz                       
unrenewed                      	 unrenewed*                     	 ənrinud                       
pastureland                    	 pastureland*                   	 pæsʧərlænd                    
barbs                          	 bɑrbz                          	 bɑrbz                         
gruesome                       	 grusəm                         	 grusəm                        
imperial                       	 ɪmpɪriəl                       	 ɪmpɪriəl                      
minae                          	 minae*                         	 mɪni                          
pongs                          	 pongs*                         	 pɔŋz                          
apprenticed                    	 əprɛntəst                      	 əprɛntəst                     
consorted                      	 consorted*                     	 kənsɔrtɪd                     
piquette                       	 pɪkɛt                          	 pikət                         
efficient                      	 ɪfɪʃənt                        	 ɪfɪʃənt                       
herl                           	 hərl                           	 hərl                          
beowulf                        	 beəwʊlf                        	 bioʊlf                        
cutups                         	 cutups*                        	 kjutəps                       
telophase                      	 telophase*                     	 tɛləfes                       
swapping                       	 swɑpɪŋ                         	 swɑpɪŋ                        
hermitage                      	 hərmətəʤ                       	 hərmətəʤ                      
ripoff                         	 rɪpɔf                          	 rɪpɔf                         
autopsy                        	 ɔtɑpsi                         	 ɔtɑpsi                        
channels                       	 ʧænəlz                         	 ʧænəlz                        
defensive                      	 dɪfɛnsɪv                       	 dɪfɛnsɪv                      
preflight                      	 preflight*                     	 priflaɪt                      
ventilatory                    	 ventilatory*                   	 vɛntɪlətɔri                   
itll                           	 itll*                          	 ɪtl                           
disbelievers                   	 disbelievers*                  	 dɪsbɪlivərz                   
nubian                         	 njubiən                        	 nubiən                        
historically                   	 hɪstɔrɪkəli                    	 hɪstɔrɪkəli                   
unequivocal                    	 ənɪkwɪvəkəl                    	 ənikwɪvəkəl                   
missile                        	 mɪsəl                          	 mɪsəl                         
partway                        	 partway*                       	 pɑrtwe                        
gel                            	 ʤɛl                            	 ʤɛl                           
guajira                        	 guajira*                       	 gwɑʤərə                       
thumbnail                      	 θəmnel                         	 θəmnel                        
smiles                         	 smaɪlz                         	 smaɪlz                        
death                          	 dɛθ                            	 dɛθ                           
coker                          	 koʊkər                         	 koʊkər                        
guesser                        	 gɛsər                          	 gɛsər                         
chaired                        	 ʧɛrd                           	 ʧɛrd                          
sweepstakes                    	 swipsteks                      	 swipsteks                     
decibel                        	 dɛsəbɛl                        	 dɛsəbɛl                       
gawkiness                      	 gawkiness*                     	 gɔkinəs                       
unpopularity                   	 ənpɑpjəlɛrɪti                  	 ənpɑpjəlɛrɪti                 
suspended                      	 səspɛndɪd                      	 səspɛndɪd                     
rowdy                          	 raʊdi                          	 raʊdi                         
firebreaks                     	 firebreaks*                    	 faɪrbreks                     
clinical                       	 klɪnɪkəl                       	 klɪnɪkəl                      
splintering                    	 splɪntərɪŋ                     	 splɪntərɪŋ                    
tar                            	 tɑr                            	 tɑr                           
sippy                          	 sippy*                         	 sɪpi                          
almightiness                   	 almightiness*                  	 ælmaɪtinəs                    
babbitt                        	 bæbɪt                          	 bæbɪt                         
lysine                         	 laɪsin                         	 laɪsin                        
sorrow                         	 sɑroʊ                          	 sɑroʊ                         
usurper                        	 usurper*                       	 jusərpər                      
proteus                        	 proteus*                       	 proʊtəs                       
unimprinted                    	 unimprinted*                   	 ənɪmprɪntəd                   
secondaries                    	 sɛkəndɛriz                     	 sɛkəndɛriz                    
writs                          	 rɪts                           	 rɪts                          
cesar                          	 sizər                          	 sisər                         
vesicles                       	 vɛzɪkəlz                       	 vɛzɪkəlz                      
disputatious                   	 disputatious*                  	 dɪspjuteʃəs                   
caused                         	 kɔzd                           	 kɔzd                          
badmouthing                    	 badmouthing*                   	 bædmaʊtɪŋ                     
submitting                     	 səbmɪtɪŋ                       	 səbmɪtɪŋ                      
sputters                       	 spətərz                        	 spətərz                       
retrain                        	 ritren                         	 ritren                        
convalescing                   	 convalescing*                  	 kɑnvəlɛsɪŋ                    
outmatched                     	 outmatched*                    	 aʊtmæʧt                       
cashews                        	 kæʃuz                          	 kæʃuz                         
flavour                        	 flavour*                       	 flævər                        
paralysed                      	 paralysed*                     	 pɛrəlɪst                      
jobless                        	 ʤɑbləs                         	 ʤɑbləs                        
stinginess                     	 stɪnʤinɪs                      	 stɪŋənəs                      
infiltrates                    	 infiltrates*                   	 ɪnfɪltrets                    
hired                          	 haɪərd                         	 haɪərd                        
havoc                          	 hævək                          	 hævək                         
unromantic                     	 unromantic*                    	 ənroʊmæntɪk                   
deterred                       	 dɪtərd                         	 dɪtərd                        
scratched                      	 skræʧt                         	 skræʧt                        
decorates                      	 decorates*                     	 dɛkərets                      
petri                          	 pɛtri                          	 pɛtri                         
chard                          	 ʧɑrd                           	 ʧɑrd                          
smileys                        	 smileys*                       	 smaɪliz                       
visa                           	 vizə                           	 vizə                          
theatregoing                   	 theatregoing*                  	 θiætrəgoʊɪŋ                   
dwarf                          	 dwɔrf                          	 dwɔrf                         
unwished                       	 unwished*                      	 ənwɪʃt                        
inadvertant                    	 inadvertant*                   	 ɪnədvərtənt                   
cries                          	 kraɪz                          	 kraɪz                         
ulcerative                     	 ulcerative*                    	 əlsərətɪv                     
cuffing                        	 cuffing*                       	 kəfɪŋ                         
boxiana                        	 boxiana*                       	 bɑksiənə                      
darkens                        	 darkens*                       	 dɑrkənz                       
microorganism                  	 maɪkroʊɔrgənɪzəm               	 maɪkroʊɔrgənɪzəm              
cantando                       	 cantando*                      	 kæntændoʊ                     
aortic                         	 eɔrtɪk                         	 eɔrtɪk                        
reloader                       	 reloader*                      	 riloʊdər                      
pelican                        	 pɛləkən                        	 pɛləkən                       
codger                         	 codger*                        	 kɑʤər                         
vertigo                        	 vərtɪgoʊ                       	 vərtɪgoʊ                      
around                         	 əraʊnd                         	 əraʊnd                        
escaper                        	 escaper*                       	 ɪskepər                       
fingerboard                    	 fɪŋgərbɔrd                     	 fɪŋgərbɔrd                    
gunl                           	 gunl*                          	 gənəl                         
ditty                          	 dɪti                           	 dɪti                          
psychoneurosis                 	 psychoneurosis*                	 saɪkoʊnəroʊsɪs                
gills                          	 gɪlz                           	 gɪlz                          
mille                          	 mɪl                            	 mɪl                           
groped                         	 groʊpt                         	 groʊpt                        
congregating                   	 congregating*                  	 kɑŋgrəgetɪŋ                   
residents                      	 rɛzɪdənts                      	 rɛzɪdənts                     
tagliarini                     	 tagliarini*                    	 tægliɛrini                    
confusers                      	 confusers*                     	 kənfjuzərz                    
cupped                         	 cupped*                        	 kəpt                          
laments                        	 ləmɛnts                        	 ləmɛnts                       
deoxygenated                   	 deoxygenated*                  	 diɑksəʤənetəd                 
holsters                       	 holsters*                      	 hoʊlstərz                     
mornay                         	 mornay*                        	 mɔrne                         
monetizing                     	 monetizing*                    	 mənɛtɪzɪŋ                     
forested                       	 fɔrəstəd                       	 fɔrəstəd                      
cowbell                        	 kaʊbɛl                         	 kaʊbɛl                        
matchbook                      	 mæʧbʊk                         	 mæʧbʊk                        
resequencing                   	 resequencing*                  	 rɛzəkwɛnsɪŋ                   
copulative                     	 copulative*                    	 kɑpjələtɪv                    
blimp                          	 blɪmp                          	 blɪmp                         
wro                            	 wro*                           	 roʊ                           
dostoevsky                     	 dɔstoʊvski                     	 dɔstoʊɛvski                   
reenact                        	 riɪnækt                        	 rinækt                        
webbing                        	 wɛbɪŋ                          	 wɛbɪŋ                         
actualization                  	 actualization*                 	 ækʧuəleʃən                    
wowing                         	 waʊɪŋ                          	 waʊɪŋ                         
sowbelly                       	 sowbelly*                      	 soʊbɛli                       
complaint                      	 kəmplent                       	 kəmplent                      
discounts                      	 dɪskaʊnts                      	 dɪskaʊnts                     
catched                        	 catched*                       	 kæʧt                          
havel                          	 hævəl                          	 hævəl                         
kb                             	 kb*                            	 kɑb                           
cistern                        	 sɪstərn                        	 sɪstərn                       
indulgent                      	 ɪndəlʤənt                      	 ɪndəlʤənt                     
misdeal                        	 misdeal*                       	 mɪsdil                        
indonesian                     	 ɪndoʊniʒən                     	 ɪndəniʒən                     
christianity                   	 krɪsʧiænɪti                    	 krɪsʧænɪti                    
psia                           	 psia*                          	 siə                           
curd                           	 kərd                           	 kərd                          
stepped                        	 stɛpt                          	 stɛpt                         
ptt                            	 ptt*                           	 tɑt                           
progressed                     	 prəgrɛst                       	 prəgrɛst                      
predominately                  	 prɪdɑmənəntli                  	 prɪdɑmənətli                  
duchy                          	 dəʧi                           	 dəʧi                          
hurrah                         	 hʊrɑ                           	 hərə                          
serfs                          	 sərfs                          	 sərfs                         
dugouts                        	 dəgaʊts                        	 dəgaʊts                       
conclusive                     	 kənklusɪv                      	 kənklusɪv                     
thoroughbreds                  	 θəroʊbrɛdz                     	 θəroʊbrɛdz                    
twenty                         	 twɛnti                         	 twɛnti                        
invigilate                     	 invigilate*                    	 ɪnvɪʤəlet                     
lastjob                        	 lastjob*                       	 læstʤɑb                       
sofia                          	 soʊfiə                         	 soʊfiə                        
evidence                       	 ɛvədəns                        	 ɛvədəns                       
latinate                       	 lætənet                        	 lætənet                       
alai                           	 əlaɪ                           	 əle                           
neurological                   	 nʊrəlɑʤɪkəl                    	 nʊrəlɑʤɪkəl                   
clutch                         	 kləʧ                           	 kləʧ                          
crumb                          	 krəm                           	 krəm                          
toast                          	 toʊst                          	 toʊst                         
piecemeal                      	 pismil                         	 pismil                        
cumulated                      	 cumulated*                     	 kjumjəletɪd                   
assistants                     	 əsɪstənts                      	 əsɪstənts                     
warring                        	 wɔrɪŋ                          	 wɔrɪŋ                         
hedgehopping                   	 hedgehopping*                  	 hɛʤhɑpɪŋ                      
fishy                          	 fɪʃi                           	 fɪʃi                          
freestone                      	 fristoʊn                       	 fristoʊn                      
mover                          	 muvər                          	 muvər                         
daters                         	 daters*                        	 detərz                        
bike                           	 baɪk                           	 baɪk                          
punchy                         	 pənʧi                          	 pənʧi                         
nucleoid                       	 nucleoid*                      	 nukliɔɪd                      
shrewder                       	 shrewder*                      	 ʃrudər                        
emigration                     	 ɛməgreʃən                      	 ɛməgreʃən                     
giga                           	 giga*                          	 gɪgə                          
underworld                     	 əndərwərld                     	 əndərwərld                    
clomp                          	 clomp*                         	 klɑmp                         
arr                            	 arr*                           	 ər                            
rhinoceros                     	 raɪnɑsərəs                     	 raɪnɑsərəs                    
paddle                         	 pædəl                          	 pædəl                         
upwelling                      	 upwelling*                     	 əpwɛlɪŋ                       
terrorizing                    	 tɛrəraɪzɪŋ                     	 tɛrəraɪzɪŋ                    
johns                          	 ʤɑnz                           	 ʤɑnz                          
programmes                     	 programmes*                    	 proʊgræmz                     
crime                          	 kraɪm                          	 kraɪm                         
update                         	 əpdet                          	 əpdet                         
terbium                        	 terbium*                       	 tərbiəm                       
miniskirts                     	 mɪniskərts                     	 mɪniskərts                    
rearming                       	 riɑrmɪŋ                        	 riɑrmɪŋ                       
unca                           	 unca*                          	 ənkə                          
finks                          	 fɪŋks                          	 fɪŋks                         
censors                        	 sɛnsərz                        	 sɛnsərz                       
bosoms                         	 bosoms*                        	 bʊzəmz                        
spasmodic                      	 spæzmɔdɪk                      	 spæzmɔdɪk                     
aftershocks                    	 æftərʃɑks                      	 æftərʃɑks                     
potshots                       	 pɑʧɑts                         	 pɑʧɑts                        
devoutness                     	 devoutness*                    	 dɪvaʊtnəs                     
kinsman                        	 kɪnzmæn                        	 kɪnzmæn                       
tetralogy                      	 tetralogy*                     	 tətrɑləʤi                     
transverter                    	 transverter*                   	 trænzvərtər                   
winnings                       	 wɪnɪŋz                         	 wɪnɪŋz                        
recreations                    	 recreations*                   	 rɛkrieʃənz                    
squashes                       	 squashes*                      	 skwɑʃɪz                       
slashing                       	 slæʃɪŋ                         	 slæʃɪŋ                        
soldier                        	 soʊlʤər                        	 soʊlʤər                       
peacocks                       	 pikɑks                         	 pikɑks                        
effectively                    	 ifɛktɪvli                      	 ifɛktɪvli                     
cougars                        	 kugərz                         	 kɔgərz                        
nows                           	 nows*                          	 naʊz                          
irretrievable                  	 irretrievable*                 	 ɪrətrivəbəl                   
fled                           	 flɛd                           	 flɛd                          
sclerae                        	 sclerae*                       	 skləri                        
crosscurrent                   	 krɔskərənt                     	 krɔskərənt                    
had                            	 hæd                            	 hæd                           
mayo                           	 meoʊ                           	 mei                           
filmgoers                      	 filmgoers*                     	 fɪlmgoʊərz                    
hypocrisy                      	 hɪpɑkrəsi                      	 hɪpɑkrəsi                     
exactly                        	 ɪgzæktli                       	 ɪgzæktli                      
bullfight                      	 bʊlfaɪt                        	 bʊlfaɪt                       
defrock                        	 defrock*                       	 dɪfrɑk                        
harlot                         	 hɑrlət                         	 hɑrlət                        
attributes                     	 ətrɪbjuts                      	 ətrɪbjuts                     
unleashed                      	 ənliʃt                         	 ənliʃt                        
wrinkling                      	 rɪŋkəlɪŋ                       	 rɪŋkəlɪŋ                      
crests                         	 krɛsts                         	 krɛsts                        
indomethacin                   	 indomethacin*                  	 ɪndɑməθəsən                   
skipjack                       	 skɪpʤæk                        	 skɪpʤæk                       
divisible                      	 dɪvɪzəbəl                      	 dɪvɪzəbəl                     
creamer                        	 krimər                         	 krimər                        
profanely                      	 profanely*                     	 proʊfenli                     
switchmen                      	 switchmen*                     	 swɪʧmɪn                       
thralls                        	 thralls*                       	 θrɔlz                         
pallor                         	 pallor*                        	 pɔlər                         
emasculated                    	 əmæskjuletɪd                   	 əmæskjuletɪd                  
jammer                         	 ʤæmər                          	 ʤæmər                         
boasting                       	 boʊstɪŋ                        	 boʊstɪŋ                       
rox                            	 rɑks                           	 rɑks                          
coatroom                       	 coatroom*                      	 koʊtrum                       
imperceptibly                  	 ɪmpərsɛptɪbli                  	 ɪmpərsɛptɪbli                 
upbeat                         	 əpbit                          	 əpbit                         
watch                          	 wɔʧ                            	 wɔʧ                           
watchword                      	 wɑʧwərd                        	 wɑʧwərd                       
shoelaces                      	 ʃulesɪz                        	 ʃulesɪz                       
compares                       	 kəmpɛrz                        	 kəmpɛrz                       
taloned                        	 taloned*                       	 tæloʊnd                       
port                           	 pɔrt                           	 pɔrt                          
shoplifting                    	 ʃɑplɪftɪŋ                      	 ʃɑplɪftɪŋ                     
hogger                         	 hogger*                        	 hɑgər                         
greed                          	 grid                           	 grid                          
outdoorsmen                    	 outdoorsmen*                   	 aʊtdɔrzmɪn                    
solipsistic                    	 solipsistic*                   	 səlɪpsɪstɪk                   
chumped                        	 chumped*                       	 ʧəmpt                         
revolves                       	 rivɑlvz                        	 rivɑlvz                       
swaggering                     	 swægərɪŋ                       	 swægərɪŋ                      
welt                           	 wɛlt                           	 wɛlt                          
blepharoplasty                 	 blepharoplasty*                	 blɛfərəplæsti                 
cadences                       	 kedənsɪz                       	 kedənsɪz                      
sported                        	 spɔrtɪd                        	 spɔrtɪd                       
plebes                         	 plebes*                        	 plibz                         
plucking                       	 pləkɪŋ                         	 pləkɪŋ                        
brawling                       	 brɔlɪŋ                         	 brɔlɪŋ                        
costumier                      	 costumier*                     	 kɑstəmjur                     
underoccupied                  	 underoccupied*                 	 əndərɑkjəpaɪd                 
premise                        	 prɛmɪs                         	 prɛmɪs                        
pacifists                      	 pæsɪfɪsts                      	 pæsɪfɪsts                     
chalice                        	 ʧælɪs                          	 ʧælɪs                         
glacial                        	 gleʃəl                         	 gleʃəl                        
punt                           	 pənt                           	 pənt                          
retiree                        	 ritaɪri                        	 ritaɪri                       
tnt                            	 tnt*                           	 tt                            
natu                           	 natu*                          	 netu                          
thionyl                        	 thionyl*                       	 θaɪənɪl                       
posterior                      	 pɔstɪrjər                      	 pɔstɪrjər                     
hiding                         	 haɪdɪŋ                         	 haɪdɪŋ                        
fumbler                        	 fumbler*                       	 fəmblər                       
polynesians                    	 polynesians*                   	 pɑliniziənz                   
systemize                      	 systemize*                     	 sɪstəmaɪz                     
grisliest                      	 grisliest*                     	 grɪzliəst                     
lawbreaking                    	 lɔbrekɪŋ                       	 lɔbrekɪŋ                      
chlorinate                     	 klɔrənet                       	 klɔrənet                      
intermastoid                   	 intermastoid*                  	 ɪntərmæstɪd                   
appropriating                  	 əproʊprietɪŋ                   	 əproʊprietɪŋ                  
underestimate                  	 əndərɛstəmet                   	 əndərɛstəmet                  
rinks                          	 rɪŋks                          	 rɪŋks                         
cherubic                       	 ʧərubɪk                        	 ʧɛrbɪk                        
pelvises                       	 pelvises*                      	 pɛlvaɪzɪz                     
upstanding                     	 əpstændɪŋ                      	 əpstændɪŋ                     
believable                     	 bəlivəbəl                      	 bəlivəbəl                     
lod                            	 lod*                           	 lɑd                           
outside                        	 aʊtsaɪd                        	 aʊtsaɪd                       
pastrami                       	 pəstrɑmi                       	 pəstrɑmi                      
menthol                        	 mɛnθɔl                         	 mɛnθhɑl                       
reddens                        	 reddens*                       	 rɛdənz                        
pincher                        	 pɪnʧər                         	 pɪnʧər                        
polishing                      	 pɑlɪʃɪŋ                        	 pɑlɪʃɪŋ                       
responsibility                 	 rispɑnsəbɪləti                 	 rispɑnsəbɪləti                
janitor                        	 ʤænətər                        	 ʤænətər                       
mice                           	 maɪs                           	 maɪs                          
prescriptions                  	 prəskrɪpʃənz                   	 prəskrɪpʃənz                  
reprehend                      	 reprehend*                     	 rɛprɪhɛnd                     
kingmaker                      	 kɪŋmekər                       	 kɪŋmekər                      
cells                          	 sɛlz                           	 sɛlz                          
improvise                      	 ɪmprəvaɪz                      	 ɪmprəvaɪz                     
despoil                        	 despoil*                       	 dɛspɔɪl                       
scalawags                      	 scalawags*                     	 skæləwægz                     
coucher                        	 coucher*                       	 kaʊʧər                        
romanced                       	 romanced*                      	 roʊmænst                      
macedoine                      	 macedoine*                     	 mækədɔɪn                      
apl                            	 apl*                           	 ep                            
insouciant                     	 ɪnsusjənt                      	 ɪnsusjənt                     
crassness                      	 crassness*                     	 kræsnəs                       
bab                            	 bæb                            	 bæb                           
seminormal                     	 seminormal*                    	 sɛmənɔrməl                    
deadest                        	 deadest*                       	 dɛdəst                        
timings                        	 timings*                       	 taɪmɪŋz                       
engorgement                    	 engorgement*                   	 ɛngɔrʤmənt                    
folies                         	 folies*                        	 foʊliz                        
schlepp                        	 ʃlɛp                           	 ʃlɛp                          
rabban                         	 rabban*                        	 ræbən                         
pre                            	 pri                            	 pri                           
environmentalists              	 ɛnvaɪrənmɛnəlɪsts              	 ɛnvaɪrənmɛnəlɪsts             
unaccommodating                	 unaccommodating*               	 ənəkɑmədetɪŋ                  
incompatibility                	 ɪnkɑmpətɪbɪlɪti                	 ɪnkɑmpətɪbɪlɪti               
hardhats                       	 hardhats*                      	 hɑrdhæts                      
wickedly                       	 wɪkɪdli                        	 wɪkɪdli                       
gres                           	 gres*                          	 grɛs                          
carmel                         	 kɑrməl                         	 kɑrməl                        
anemias                        	 ənimiəz                        	 ənimiəz                       
geostationary                  	 geostationary*                 	 ʤioʊsteʃənɛri                 
silliest                       	 sɪliəst                        	 sɪliəst                       
marathons                      	 mɛrəθɑnz                       	 mɛrəθɑnz                      
coaxed                         	 koʊkst                         	 koʊkst                        
slaughterhouses                	 slɔtərhaʊsɪz                   	 slɔtərhaʊsəz                  
groundswell                    	 graʊndswɛl                     	 graʊndswɛl                    
marquee                        	 mɑrki                          	 mɑrki                         
outstandings                   	 outstandings*                  	 aʊtstændɪŋz                   
laborously                     	 laborously*                    	 læbərəsli                     
lipa                           	 lipə                           	 laɪpə                         
pastor                         	 pæstər                         	 pæstər                        
clum                           	 kləm                           	 kləm                          
sentimentalist                 	 sentimentalist*                	 sɛnəmɛnəlɪst                  
ewes                           	 juz                            	 juz                           
loudering                      	 loudering*                     	 laʊdərɪŋ                      
coonskin                       	 coonskin*                      	 kunskɪn                       
ascending                      	 əsɛndɪŋ                        	 əsɛndɪŋ                       
snuffles                       	 snuffles*                      	 snəfəlz                       
norwegian                      	 nɔrwiʤən                       	 nɔrwɛʤən                      
pouncing                       	 paʊnsɪŋ                        	 paʊnsɪŋ                       
consuming                      	 kənsumɪŋ                       	 kənsumɪŋ                      
borrow                         	 bɑroʊ                          	 bɑroʊ                         
larcenous                      	 lɑrsənəs                       	 lɑrsənəs                      
entrants                       	 ɛntrənts                       	 ɛntrənts                      
camelback                      	 camelback*                     	 kemlæk                        
planeload                      	 plenloʊd                       	 plænəloʊd                     
jerkins                        	 ʤərkɪnz                        	 ʤərkɪnz                       
disorientated                  	 disorientated*                 	 dɪsɔriɛntetɪd                 
scarcer                        	 skɛrsər                        	 skɛrsər                       
store                          	 stɔr                           	 stɔr                          
laver                          	 levər                          	 levər                         
looped                         	 lupt                           	 lupt                          
inoculations                   	 ɪnɑkjəleʃənz                   	 ɪnɑkjəleʃənz                  
cutup                          	 cutup*                         	 kjutəp                        
sandcastles                    	 sandcastles*                   	 sændkæstəlz                   
vandalising                    	 vandalising*                   	 vændəlaɪzɪŋ                   
consultants                    	 kənsəltənts                    	 kənsəltənts                   
defeats                        	 dɪfits                         	 dɪfits                        
keys                           	 kiz                            	 kiz                           
marica                         	 marica*                        	 mɛrɪkə                        
trough                         	 trɔf                           	 trɔf                          
trouncing                      	 traʊnsɪŋ                       	 traʊnsɪŋ                      
qu                             	 ku                             	 kwə                           
those                          	 ðoʊz                           	 ðoʊz                          
finely                         	 faɪnli                         	 faɪnli                        
inconsequentiality             	 inconsequentiality*            	 ɪnkɑnsəkwɛnʃələti             
liberator                      	 lɪbəretər                      	 lɪbəretər                     
hayseeds                       	 hayseeds*                      	 hesidz                        
mis                            	 mɪs                            	 mɪs                           
olde                           	 oʊld                           	 oʊld                          
sifts                          	 sɪfts                          	 sɪfts                         
arbitrarily                    	 ɑrbɪtrɛrəli                    	 ɑrbɪtrɛrəli                   
hern                           	 hərn                           	 hərn                          
asthmatics                     	 ɛsθmɛtɪks                      	 ɛsθmɛtɪks                     
chukker                        	 chukker*                       	 ʧəkər                         
nebuliser                      	 nebuliser*                     	 nɛbjəlɪsər                    
fingered                       	 fɪŋgərd                        	 fɪŋgərd                       
deny                           	 dɪnaɪ                          	 dɪnaɪ                         
graying                        	 greɪŋ                          	 greɪŋ                         
isolde                         	 ɪsoʊld                         	 aɪsoʊld                       
breakups                       	 brekəps                        	 brekəps                       
bluster                        	 bləstər                        	 bləstər                       
thunderstruck                  	 θəndərstrək                    	 θəndərstrək                   
jillions                       	 ʤɪljənz                        	 ʤɪljənz                       
metabolisms                    	 mətæbəlɪzəmz                   	 mətæbəlɪzəmz                  
pirouetting                    	 pirouetting*                   	 pɪruɛtɪŋ                      
skelp                          	 skelp*                         	 skɛlp                         
peen                           	 peen*                          	 pin                           
makings                        	 mekɪŋz                         	 mekɪŋz                        
encompasses                    	 ɛnkəmpəsəz                     	 ɛnkəmpəsəz                    
exonerates                     	 ɪgzɑnərets                     	 ɪgzɑnərets                    
db                             	 db*                            	 dɑktər                        
supine                         	 supaɪn                         	 supaɪn                        
styrax                         	 styrax*                        	 staɪræks                      
unavoidably                    	 ənəvɔɪdəbli                    	 ənəvɔɪdəbli                   
barhopping                     	 barhopping*                    	 bɑrhɑpɪŋ                      
limbless                       	 lɪmləs                         	 lɪmbləs                       
dallying                       	 dallying*                      	 dæliɪŋ                        
suckles                        	 suckles*                       	 səkəlz                        
especial                       	 əspɛʃəl                        	 əspɛʃəl                       
wraps                          	 ræps                           	 ræps                          
pivot                          	 pɪvət                          	 pɪvət                         
ensuite                        	 ensuite*                       	 ɛnsut                         
counterpart                    	 kaʊntərpɑrt                    	 kaʊntərpɑrt                   
facilitated                    	 fəsɪlətetɪd                    	 fəsɪlətetɪd                   
agreat                         	 agreat*                        	 egriet                        
instated                       	 instated*                      	 ɪnstetɪd                      
licks                          	 lɪks                           	 lɪks                          
depositors                     	 dəpɑzɪtərz                     	 dɪpɑzətərz                    
geographical                   	 ʤiəgræfɪkəl                    	 ʤiəgræfɪkəl                   
hesitate                       	 hɛzətet                        	 hɛzətet                       
grassy                         	 græsi                          	 græsi                         
freeway                        	 friwe                          	 friwe                         
foreseeing                     	 fɔrsiɪŋ                        	 fɔrsiɪŋ                       
lifeboats                      	 laɪfboʊts                      	 laɪfboʊts                     
edaphology                     	 edaphology*                    	 ɛdəfɑləʤi                     
revolutionise                  	 revolutionise*                 	 rɛvəluʃənəs                   
trial                          	 traɪəl                         	 traɪəl                        
underhandedly                  	 underhandedly*                 	 əndərhændɪdli                 
gingersnap                     	 gingersnap*                    	 ʤɪnʤərznæp                    
carpet                         	 kɑrpət                         	 kɑrpət                        
shivered                       	 ʃɪvərd                         	 ʃɪvərd                        
ram                            	 ræm                            	 ræm                           
indoctrinate                   	 indoctrinate*                  	 ɪndɑktrənet                   
bypasses                       	 baɪpæsɪz                       	 baɪpæsɪz                      
mournful                       	 mɔrnfəl                        	 mɔrnfəl                       
billboards                     	 bɪlbɔrdz                       	 bɪlbɔrdz                      
fleecy                         	 flisi                          	 flisi                         
diddlysquat                    	 diddlysquat*                   	 dɪdlɪskwɑt                    
stradivarius                   	 strædɪvɛriəs                   	 strədɪvɛriəs                  
unrealized                     	 ənriəlaɪzd                     	 ənrilaɪzd                     
chairing                       	 ʧɛrɪŋ                          	 ʧɛrɪŋ                         
hillside                       	 hɪlsaɪd                        	 hɪlsaɪd                       
tokes                          	 tokes*                         	 toʊks                         
gentlemanlike                  	 gentlemanlike*                 	 ʤɛnəlmænlaɪk                  
squadron                       	 skwɑdrən                       	 skwɑdrən                      
synced                         	 synced*                        	 sɪnst                         
leonid                         	 liənɪd                         	 liɑnɪd                        
infuser                        	 infuser*                       	 ɪnfjuzər                      
tapestries                     	 tæpəstriz                      	 tepstriz                      
sea                            	 si                             	 si                            
contemplating                  	 kɑntəmpletɪŋ                   	 kɑntəmpletɪŋ                  
hoes                           	 hoʊz                           	 hoʊz                          
armload                        	 armload*                       	 ɑrmloʊd                       
counterpoise                   	 counterpoise*                  	 kaʊntərpɔɪz                   
tradition                      	 trədɪʃən                       	 trədɪʃən                      
thunderball                    	 thunderball*                   	 θəndərbɔl                     
puzzler                        	 pəzlər                         	 pəzlər                        
arrangements                   	 ərenʤmənts                     	 ərenʤmənts                    
carpentering                   	 carpentering*                  	 kɑrpəntɛrɪŋ                   
masturbator                    	 masturbator*                   	 mæstərbetər                   
freebasing                     	 freebasing*                    	 fribesɪŋ                      
habiliments                    	 habiliments*                   	 həbɪlmənts                    
machismo                       	 məʧɪzmoʊ                       	 məʃɪzmoʊ                      
nobodies                       	 noʊbɑdiz                       	 noʊbɑdiz                      
venting                        	 vɛntɪŋ                         	 vɛntɪŋ                        
doorknob                       	 durnɑb                         	 durnɑb                        
coraggio                       	 coraggio*                      	 kəræʤioʊ                      
standouts                      	 stændaʊts                      	 stændaʊts                     
raping                         	 repɪŋ                          	 repɪŋ                         
nit                            	 nɪt                            	 nɪt                           
housing                        	 haʊzɪŋ                         	 haʊzɪŋ                        
merrymen                       	 merrymen*                      	 mɛrimən                       
mommie                         	 mommie*                        	 mɑmi                          
senior                         	 sinjər                         	 sinjər                        
thermals                       	 thermals*                      	 θərməlz                       
lambkin                        	 lambkin*                       	 læmkɪn                        
allow                          	 əlaʊ                           	 əlaʊ                          
senhorita                      	 senhorita*                     	 sɛnhɔrətə                     
surgeon                        	 sərʤɪn                         	 sərʤɪn                        
irrelevancy                    	 ɪrɛləvənsi                     	 ɪrɛləvənsi                    
discolour                      	 discolour*                     	 dɪskələr                      
blotted                        	 blɑtəd                         	 blɑtəd                        
boldface                       	 boʊldfes                       	 boʊldfes                      
shears                         	 ʃirz                           	 ʃirz                          
skimping                       	 skɪmpɪŋ                        	 skɪmpɪŋ                       
guillotines                    	 guillotines*                   	 gɪlətinz                      
multiplication                 	 məltəpləkeʃən                  	 məltəpləkeʃən                 
croaks                         	 croaks*                        	 kroʊks                        
yogurt                         	 joʊgərt                        	 joʊgərt                       
transsexualism                 	 transsexualism*                	 trænsɛkʃuəlɪzəm               
picks                          	 pɪks                           	 pɪks                          
swash                          	 swash*                         	 swɑʃ                          
tablespoons                    	 tebəlspunz                     	 tebəlspunz                    
communicate                    	 kəmjunəket                     	 kəmjunəket                    
akin                           	 ekɪn                           	 ekɪn                          
seismologists                  	 saɪzmɑləʤɪsts                  	 saɪzmɑləʤɪsts                 
prisses                        	 prisses*                       	 prɪsɪz                        
mimetic                        	 mimetic*                       	 mɪmtɪk                        
barrelling                     	 barrelling*                    	 bɛrəlɪŋ                       
facials                        	 feʃəlz                         	 feʃəlz                        
chippies                       	 chippies*                      	 ʧɪpiz                         
determinants                   	 dɪtərmənənts                   	 dɪtərmənənts                  
forbears                       	 forbears*                      	 fɔrbɛrz                       
foist                          	 fɔɪst                          	 fɔɪst                         
toots                          	 tʊts                           	 tuts                          
indiscernible                  	 indiscernible*                 	 ɪndɪsərnɪbəl                  
cicerone                       	 sɪsəroʊn                       	 sɪsəroʊn                      
segment                        	 sɛgmɛnt                        	 sɛgmɛnt                       
ledgers                        	 lɛʤərz                         	 lɛʤərz                        
tried                          	 traɪd                          	 traɪd                         
screenland                     	 screenland*                    	 skrinlænd                     
pornographies                  	 pornographies*                 	 pɔrnɑgrəfiz                   
stinkeroos                     	 stinkeroos*                    	 stɪŋkəruz                     
hibiscus                       	 hibiscus*                      	 hɪbəskəs                      
dumpling                       	 dəmplɪŋ                        	 dəmplɪŋ                       
bristling                      	 brɪsəlɪŋ                       	 brɪsəlɪŋ                      
virulent                       	 vɪrələnt                       	 vɪrələnt                      
scenery                        	 sinəri                         	 sinəri                        
defacto                        	 defacto*                       	 dɪfæktoʊ                      
murmur                         	 mərmər                         	 mərmər                        
deductible                     	 dɪdəktəbəl                     	 dɪdəktəbəl                    
lamebrain                      	 lamebrain*                     	 lembren                       
jigs                           	 ʤɪgz                           	 ʤɪgz                          
flit                           	 flɪt                           	 flɪt                          
browning                       	 braʊnɪŋ                        	 braʊnɪŋ                       
slot                           	 slɑt                           	 slɑt                          
barker                         	 bɑrkər                         	 bɑrkər                        
bodysurf                       	 bodysurf*                      	 bɑdisərf                      
binocular                      	 bənɑkjələr                     	 bənɑkjələr                    
playable                       	 playable*                      	 pleəbəl                       
brushstrokes                   	 brushstrokes*                  	 brəʃstroʊks                   
logos                          	 loʊgoʊz                        	 loʊgoʊz                       
film                           	 fɪlm                           	 fɪlm                          
provinces                      	 prɑvənsəz                      	 prɑvənsəz                     
zn                             	 zn*                            	 znɑ                           
bay                            	 be                             	 be                            
gabby                          	 gæbi                           	 gæbi                          
purring                        	 pərɪŋ                          	 pərɪŋ                         
therapeutics                   	 θɛrəpjutɪks                    	 θɛrəpjutɪks                   
prepared                       	 pripɛrd                        	 pripɛrd                       
cumming                        	 kəmɪŋ                          	 kəmɪŋ                         
feel                           	 fil                            	 fil                           
economist                      	 ɪkɑnəmɪst                      	 ɪkɑnəmɪst                     
tenders                        	 tɛndərz                        	 tɛndərz                       
gent                           	 ʤɛnt                           	 ʤɛnt                          
hatchway                       	 hatchway*                      	 hæʧwe                         
responses                      	 rɪspɑnsɪz                      	 rɪspɑnsɪz                     
chef                           	 ʃɛf                            	 ʃɛf                           
meddling                       	 mɛdəlɪŋ                        	 mɛdəlɪŋ                       
tenable                        	 tɛnəbəl                        	 tɛnəbəl                       
debriefs                       	 dɪbrifs                        	 dɪbrifs                       
ergonomically                  	 ərgənɑmɪkli                    	 ərgənɑmɪkli                   
prim                           	 prɪm                           	 prɪm                          
whee                           	 whee*                          	 wi                            
clever                         	 klɛvər                         	 klɛvər                        
harrow                         	 hæroʊ                          	 hɛroʊ                         
extrasensory                   	 ɛkstrəsɛnsəri                  	 ɛkstræsənsəri                 
hadj                           	 hadj*                          	 hæʤ                           
irresilient                    	 irresilient*                   	 ɪrɪzɪljənt                    
drooled                        	 drooled*                       	 druld                         
indissoluble                   	 indissoluble*                  	 ɪndɪsələbəl                   
appropriation                  	 əproʊprieʃən                   	 əproʊprieʃən                  
channelling                    	 channelling*                   	 ʧænəlɪŋ                       
suppositions                   	 səpəzɪʃənz                     	 səpəzɪʃənz                    
palominos                      	 palominos*                     	 pæləmɪnz                      
rami                           	 rɑmi                           	 rɑmi                          
pruned                         	 prund                          	 prund                         
uncannily                      	 ənkænəli                       	 ənkænəli                      
dopey                          	 doʊpi                          	 doʊpi                         
warmongering                   	 wɔrmɑŋgərɪŋ                    	 wɔrmɑŋgərɪŋ                   
duplication                    	 djupləkeʃən                    	 dupləkeʃən                    
uncorrupted                    	 uncorrupted*                   	 ənkərəptɪd                    
combustible                    	 combustible*                   	 kəmbəstəbəl                   
youths                         	 juθs                           	 juθs                          
blowers                        	 bloʊərz                        	 bloʊərz                       
commercialising                	 commercialising*               	 kəmərʃəlɪŋ                    
descending                     	 dɪsɛndɪŋ                       	 dɪsɛndɪŋ                      
refrigerated                   	 rɪfrɪʤəretɪd                   	 rɪfrɪʤəretɪd                  
fidgets                        	 fidgets*                       	 fɪʤəts                        
genealogies                    	 genealogies*                   	 ʤiniɑləʤiz                    
brat                           	 bræt                           	 bræt                          
midriffs                       	 midriffs*                      	 mɪdrɪfs                       
granddaddies                   	 granddaddies*                  	 grændədiz                     
pierces                        	 pierces*                       	 pɪrsɪz                        
silly                          	 sɪli                           	 sɪli                          
timing                         	 taɪmɪŋ                         	 taɪmɪŋ                        
tristate                       	 traɪstet                       	 trɪstet                       
kidnap                         	 kɪdnæp                         	 kɪdnæp                        
clauses                        	 klɔzɪz                         	 klɔzɪz                        
puritanism                     	 pjʊrətənɪzəm                   	 pjʊrətənɪzəm                  
gemstones                      	 ʤɛmstoʊnz                      	 ʤɛmstoʊnz                     
conciliation                   	 kənsɪlieʃən                    	 kənsɪlieʃən                   
gingerbread                    	 ʤɪnʤərbrɛd                     	 ʤɪnʤərbrɛd                    
diptych                        	 diptych*                       	 dɪptɪk                        
primarily                      	 praɪmɛrəli                     	 praɪmɛrəli                    
perpetuate                     	 pərpɛʧəwet                     	 pərpɛʧəwet                    
uneaten                        	 uneaten*                       	 ənitən                        
trashman                       	 trashman*                      	 træʃmən                       
divide                         	 dɪvaɪd                         	 dɪvaɪd                        
degenerating                   	 dɪʤɛnəretɪŋ                    	 dɪʤɛnəretɪŋ                   
hamadryas                      	 hamadryas*                     	 hæmədriəz                     
limitless                      	 lɪmətləs                       	 lɪmətləs                      
cosmologies                    	 cosmologies*                   	 kɔzmɔləʤiz                    
latch                          	 læʧ                            	 læʧ                           
burrow                         	 bəroʊ                          	 bəroʊ                         
european                       	 jʊrəpiən                       	 jʊrəpiən                      
remorse                        	 rɪmɔrs                         	 rɪmɔrs                        
pictured                       	 pɪkʧərd                        	 pɪkʧərd                       
readiest                       	 readiest*                      	 rɛdiəst                       
acting                         	 æktɪŋ                          	 æktɪŋ                         
inexcusably                    	 ɪnɪkskjuzəbli                  	 ɪnɪkskjuzəbli                 
vietnamization                 	 vietnamization*                	 vɪtnəmeʃən                    
unreality                      	 ənriæləti                      	 ənriæləti                     
templars                       	 tɛmplərz                       	 tɛmplɑrz                      
jeepers                        	 jeepers*                       	 ʤipərz                        
masai                          	 mɑsɑi                          	 mɑse                          
prelate                        	 prɛlɪt                         	 prɛlɪt                        
uncontestable                  	 uncontestable*                 	 ənkəntɛstəbəl                 
canale                         	 kɑnɑli                         	 kənæle                        
canker                         	 kæŋkər                         	 kæŋkər                        
concurred                      	 kənkərd                        	 kənkərd                       
brutish                        	 brutɪʃ                         	 brutɪʃ                        
entanglements                  	 ɪntæŋgəlmənts                  	 ɪntæŋgəlmənts                 
intellectually                 	 ɪnəlɛkʧuəli                    	 ɪnəlɛkʧuəli                   
nerviness                      	 nerviness*                     	 nərvinəs                      
censored                       	 sɛnsərd                        	 sɛnsərd                       
nijinsky                       	 nijinsky*                      	 nɪʤɪnski                      
lowlife                        	 lowlife*                       	 loʊlɪf                        
bribes                         	 braɪbz                         	 braɪbz                        
wassailing                     	 wassailing*                    	 wɑselɪŋ                       
smug                           	 sməg                           	 sməg                          
hybridized                     	 hybridized*                    	 haɪbraɪdaɪzd                  
squats                         	 skwɑts                         	 skwɑts                        
slack                          	 slæk                           	 slæk                          
cawker                         	 cawker*                        	 kɔkər                         
goodish                        	 goodish*                       	 gʊdɪʃ                         
gangrene                       	 gængrin                        	 gæŋgrin                       
fop                            	 ɛfoʊpi                         	 fɑp                           
transparency                   	 trænspɛrənsi                   	 trænspɛrənsi                  
tuberoses                      	 tuberoses*                     	 tubəroʊsɪz                    
assignations                   	 assignations*                  	 æsəgneʃənz                    
steamboat                      	 stimboʊt                       	 stimboʊt                      
dialogued                      	 dialogued*                     	 daɪəlɔgd                      
bushwhack                      	 bʊʃwæk                         	 bʊʃwæk                        
fetish                         	 fɛtɪʃ                          	 fɛtɪʃ                         
fumette                        	 fumette*                       	 fjumɛt                        
suspicion                      	 səspɪʃən                       	 səspɪʃən                      
parasitic                      	 pɛrəsɪtɪk                      	 pɛrəsɪtɪk                     
idling                         	 aɪdəlɪŋ                        	 aɪdəlɪŋ                       
puppeteer                      	 pəpətir                        	 pəpətir                       
dispirit                       	 dispirit*                      	 dɪspɪrət                      
wiretap                        	 waɪərtæp                       	 waɪrtep                       
volta                          	 voʊltə                         	 voʊltə                        
columbo                        	 koʊləmboʊ                      	 kələmboʊ                      
severest                       	 səvɪrəst                       	 səvɪrəst                      
pigpen                         	 pigpen*                        	 pɪgən                         
offing                         	 ɔfɪŋ                           	 ɔfɪŋ                          
payed                          	 payed*                         	 ped                           
opt                            	 ɑpt                            	 ɑpt                           
instills                       	 ɪnstɪlz                        	 ɪnstɪlz                       
yarmulka                       	 yarmulka*                      	 jɑrməlkə                      
ruminate                       	 rumɪnet                        	 rumɪnet                       
code                           	 koʊd                           	 koʊd                          
napper                         	 næpər                          	 næpər                         
compounded                     	 kəmpaʊndɪd                     	 kəmpaʊndɪd                    
transcribed                    	 trænskraɪbd                    	 trænskraɪbd                   
lavender                       	 lævəndər                       	 lævəndər                      
blackbirds                     	 blækbərdz                      	 blækbərdz                     
thuggees                       	 thuggees*                      	 θəgiz                         
azan                           	 azan*                          	 æzən                          
compatibility                  	 kəmpætəbɪləti                  	 kɑmpətɪbɪlɪti                 
reconvene                      	 rikənvin                       	 rikənvin                      
moulding                       	 moʊldɪŋ                        	 moʊldɪŋ                       
constances                     	 constances*                    	 kɑnstənsɪz                    
futons                         	 futɑnz                         	 futɑnz                        
ruble                          	 rubəl                          	 rubəl                         
separatists                    	 sɛpərətɪsts                    	 sɛpərətɪsts                   
gougers                        	 gougers*                       	 gaʊʤərz                       
adaptable                      	 ədæptəbəl                      	 ədæptəbəl                     
quoted                         	 kwoʊtɪd                        	 kwoʊtɪd                       
apprehending                   	 æprɪhɛndɪŋ                     	 æprɪhɛndɪŋ                    
quaker                         	 kwekər                         	 kwekər                        
armenia                        	 ɑrminiə                        	 ɑrminiə                       
herefrom                       	 herefrom*                      	 hɪrfrəm                       
hostile                        	 hɑstəl                         	 hɑstəl                        
handshaker                     	 handshaker*                    	 hændʃekər                     
lodestone                      	 loʊdstoʊn                      	 loʊdstoʊn                     
crossroad                      	 krɔsroʊd                       	 krɔsroʊd                      
headman                        	 hɛdmən                         	 hɛdmæn                        
scuffing                       	 scuffing*                      	 skəfɪŋ                        
freesia                        	 freesia*                       	 friʒə                         
heroically                     	 hɪroʊɪkli                      	 hɪroʊɪkli                     
stupidity                      	 stupɪdɪti                      	 stupɪdɪti                     
eardrops                       	 eardrops*                      	 ərdrɑps                       
crossbar                       	 crossbar*                      	 krɔsbɑr                       
ringleader                     	 rɪŋlidər                       	 rɪŋlidər                      
propylene                      	 proʊpəlin                      	 proʊpəlin                     
pegs                           	 pɛgz                           	 pɛgz                          
antigen                        	 æntəʤən                        	 æntəʤən                       
rimption                       	 rimption*                      	 rɪmpʃən                       
neuropharmacologist            	 neuropharmacologist*           	 nʊrəfɑrməkəlɑʤɪst             
turner                         	 tərnər                         	 tərnər                        
lethal                         	 liθəl                          	 liθəl                         
underslung                     	 underslung*                    	 əndərsləŋ                     
astonishment                   	 əstɑnɪʃmənt                    	 əstɑnɪʃmənt                   
ultrasound                     	 əltrəsaʊnd                     	 əltrəsaʊnd                    
idolizes                       	 aɪdəlaɪzɪz                     	 aɪdəlaɪzɪz                    
biochemical                    	 baɪoʊkɛmɪkəl                   	 baɪoʊkɛmɪkəl                  
embrace                        	 ɪmbres                         	 ɪmbres                        
naturalists                    	 næʧərəlɪsts                    	 næʧərəlɪsts                   
cleansed                       	 klɛnzd                         	 klɛnzd                        
hyperemesis                    	 hyperemesis*                   	 haɪpərmizɪs                   
foreleg                        	 foreleg*                       	 fɔrlɛg                        
debbie                         	 dɛbi                           	 dɛbi                          
run                            	 rən                            	 rən                           
marshalling                    	 marshalling*                   	 mɑrʃəlɪŋ                      
dumbfound                      	 dəmfaʊnd                       	 dəmfaʊnd                      
nixon                          	 nɪksən                         	 nɪksən                        
reenacted                      	 riɪnæktɪd                      	 rinæktəd                      
wilds                          	 waɪldz                         	 waɪldz                        
lymphocyte                     	 lɪmfəsaɪt                      	 lɪmfəsaɪt                     
economizing                    	 ɪkɑnəmaɪzɪŋ                    	 ɛkənɑmɪzɪŋ                    
siting                         	 saɪtɪŋ                         	 saɪtɪŋ                        
supermen                       	 supermen*                      	 supərmɛn                      
gunships                       	 gənʃɪps                        	 gənʃɪps                       
wirehair                       	 wirehair*                      	 waɪrhɛr                       
puss                           	 pʊs                            	 pʊs                           
wilton                         	 wɪltən                         	 wɪltən                        
masthead                       	 mæsthɛd                        	 mæsthɛd                       
waster                         	 westər                         	 westər                        
puddle                         	 pədəl                          	 pədəl                         
shoddiest                      	 shoddiest*                     	 ʃɑdiəst                       
tot                            	 tɑt                            	 tɔt                           
influential                    	 ɪnfluɛnʃəl                     	 ɪnfluɛnʃəl                    
kinds                          	 kaɪnz                          	 kaɪnz                         
reinforce                      	 riɪnfɔrs                       	 riɪnfɔrs                      
patellar                       	 patellar*                      	 pətɛlər                       
peels                          	 pilz                           	 pilz                          
pariahs                        	 pəraɪəz                        	 pəraɪəz                       
repartee                       	 rɛpərti                        	 rɛpərti                       
anglophile                     	 ængləfaɪl                      	 æŋgləfaɪl                     
prostate                       	 prɑstet                        	 prɑstet                       
frightening                    	 fraɪtənɪŋ                      	 fraɪtənɪŋ                     
gunwales                       	 gunwales*                      	 gənwelz                       
wiedersehen                    	 wiedersehen*                   	 widərshɛn                     
hospice                        	 hɑspəs                         	 hɑspəs                        
beaner                         	 beaner*                        	 binər                         
toffee                         	 tɑfi                           	 tɑfi                          
alexanders                     	 ælɪgzændərz                    	 ælɛksəndərz                   
prie                           	 prie*                          	 praɪ                          
crabman                        	 crabman*                       	 kræbmən                       
uncompromisingly               	 uncompromisingly*              	 ənkɑmprəmaɪzɪŋli              
freestyle                      	 fristaɪl                       	 fristaɪl                      
buntline                       	 buntline*                      	 bəntlaɪn                      
carters                        	 kɑrtərz                        	 kɑrtərz                       
faubourg                       	 faubourg*                      	 fɔbərg                        
rheumatology                   	 rumətɑləʤi                     	 rumətɑləʤi                    
quakerism                      	 quakerism*                     	 kwekərɪzəm                    
unexpectedly                   	 ənɪkspɛktɪdli                  	 ənɪkspɛktɪdli                 
aides                          	 edz                            	 edz                           
splurge                        	 splərʤ                         	 splərʤ                        
routines                       	 rutinz                         	 rutinz                        
postdoctoral                   	 poʊstdɑktərəl                  	 poʊstdɑktərəl                 
tweedledum                     	 tweedledum*                    	 twidlɛʤəm                     
darwin                         	 dɑrwɪn                         	 dɑrwɪn                        
impregnation                   	 ɪmprɛgneʃən                    	 ɪmprɛgneʃən                   

 
 No IPA translation using library: 340 (34.0%) 
IPA translation that is the same using the library and model: 592 (89.6969696969697%) 
SED Average Including when SED is 0: 113/660 (0.1712121212121212) 
SED Average Excluding when SED is 0: 113/68 (1.661764705882353) 

 
 Words that have different IPA Transcriptions 
enoch                          	 inək                           	 ɪnɑk                           	 String Edit Distance 2  
chateaux                       	 ʃətoʊ                          	 ʧetoʊ                          	 String Edit Distance 2  
scala                          	 skɑlə                          	 skelə                          	 String Edit Distance 1  
colloquium                     	 kəloʊkwiəm                     	 kəloʊkwəm                      	 String Edit Distance 1  
nonevent                       	 nɑnɪvɛnt                       	 nɑnəvənt                       	 String Edit Distance 2  
santos                         	 sæntoʊs                        	 sæntoʊz                        	 String Edit Distance 1  
disproven                      	 dɪspruvɪn                      	 dɪspruvən                      	 String Edit Distance 1  
landscaper                     	 lændskepər                     	 lænskepər                      	 String Edit Distance 1  
anesthesiologist               	 ænəsθiziɑləʤɪst                	 ænɪsθiʒiɑləʤɪst                	 String Edit Distance 2  
gish                           	 ʤɪʃ                            	 gɪʃ                            	 String Edit Distance 1  
colombian                      	 kələmbiən                      	 kəlɑmbiən                      	 String Edit Distance 1  
asmodeus                       	 æzmədeəs                       	 əsmoʊdəs                       	 String Edit Distance 5  
tristram                       	 trɪstrəm                       	 trɪstræm                       	 String Edit Distance 1  
efforts                        	 ɛfərts                         	 ɪfɔrts                         	 String Edit Distance 2  
finessed                       	 fɪnɛst                         	 faɪnɛst                        	 String Edit Distance 1  
reaganomics                    	 regənɑmɪks                     	 rigənɑmɪks                     	 String Edit Distance 1  
pers                           	 pərs                           	 pərz                           	 String Edit Distance 1  
octillion                      	 ɑktɪljən                       	 ɔktɪljən                       	 String Edit Distance 1  
pompoms                        	 pɑmpɑmz                        	 pɑmpəmz                        	 String Edit Distance 1  
piquette                       	 pɪkɛt                          	 pikət                          	 String Edit Distance 2  
beowulf                        	 beəwʊlf                        	 bioʊlf                         	 String Edit Distance 3  
nubian                         	 njubiən                        	 nubiən                         	 String Edit Distance 1  
unequivocal                    	 ənɪkwɪvəkəl                    	 ənikwɪvəkəl                    	 String Edit Distance 1  
cesar                          	 sizər                          	 sisər                          	 String Edit Distance 1  
stinginess                     	 stɪnʤinɪs                      	 stɪŋənəs                       	 String Edit Distance 4  
dostoevsky                     	 dɔstoʊvski                     	 dɔstoʊɛvski                    	 String Edit Distance 1  
reenact                        	 riɪnækt                        	 rinækt                         	 String Edit Distance 1  
indonesian                     	 ɪndoʊniʒən                     	 ɪndəniʒən                      	 String Edit Distance 2  
christianity                   	 krɪsʧiænɪti                    	 krɪsʧænɪti                     	 String Edit Distance 1  
predominately                  	 prɪdɑmənəntli                  	 prɪdɑmənətli                   	 String Edit Distance 1  
hurrah                         	 hʊrɑ                           	 hərə                           	 String Edit Distance 2  
alai                           	 əlaɪ                           	 əle                            	 String Edit Distance 2  
cougars                        	 kugərz                         	 kɔgərz                         	 String Edit Distance 1  
mayo                           	 meoʊ                           	 mei                            	 String Edit Distance 2  
cherubic                       	 ʧərubɪk                        	 ʧɛrbɪk                         	 String Edit Distance 2  
menthol                        	 mɛnθɔl                         	 mɛnθhɑl                        	 String Edit Distance 2  
slaughterhouses                	 slɔtərhaʊsɪz                   	 slɔtərhaʊsəz                   	 String Edit Distance 1  
lipa                           	 lipə                           	 laɪpə                          	 String Edit Distance 2  
norwegian                      	 nɔrwiʤən                       	 nɔrwɛʤən                       	 String Edit Distance 1  
planeload                      	 plenloʊd                       	 plænəloʊd                      	 String Edit Distance 2  
qu                             	 ku                             	 kwə                            	 String Edit Distance 2  
isolde                         	 ɪsoʊld                         	 aɪsoʊld                        	 String Edit Distance 1  
limbless                       	 lɪmləs                         	 lɪmbləs                        	 String Edit Distance 1  
depositors                     	 dəpɑzɪtərz                     	 dɪpɑzətərz                     	 String Edit Distance 2  
stradivarius                   	 strædɪvɛriəs                   	 strədɪvɛriəs                   	 String Edit Distance 1  
unrealized                     	 ənriəlaɪzd                     	 ənrilaɪzd                      	 String Edit Distance 1  
leonid                         	 liənɪd                         	 liɑnɪd                         	 String Edit Distance 1  
tapestries                     	 tæpəstriz                      	 tepstriz                       	 String Edit Distance 2  
machismo                       	 məʧɪzmoʊ                       	 məʃɪzmoʊ                       	 String Edit Distance 1  
toots                          	 tʊts                           	 tuts                           	 String Edit Distance 1  
harrow                         	 hæroʊ                          	 hɛroʊ                          	 String Edit Distance 1  
extrasensory                   	 ɛkstrəsɛnsəri                  	 ɛkstræsənsəri                  	 String Edit Distance 2  
duplication                    	 djupləkeʃən                    	 dupləkeʃən                     	 String Edit Distance 1  
tristate                       	 traɪstet                       	 trɪstet                        	 String Edit Distance 1  
templars                       	 tɛmplərz                       	 tɛmplɑrz                       	 String Edit Distance 1  
masai                          	 mɑsɑi                          	 mɑse                           	 String Edit Distance 2  
canale                         	 kɑnɑli                         	 kənæle                         	 String Edit Distance 3  
gangrene                       	 gængrin                        	 gæŋgrin                        	 String Edit Distance 1  
fop                            	 ɛfoʊpi                         	 fɑp                            	 String Edit Distance 4  
wiretap                        	 waɪərtæp                       	 waɪrtep                        	 String Edit Distance 2  
columbo                        	 koʊləmboʊ                      	 kələmboʊ                       	 String Edit Distance 2  
compatibility                  	 kəmpætəbɪləti                  	 kɑmpətɪbɪlɪti                  	 String Edit Distance 4  
headman                        	 hɛdmən                         	 hɛdmæn                         	 String Edit Distance 1  
reenacted                      	 riɪnæktɪd                      	 rinæktəd                       	 String Edit Distance 2  
economizing                    	 ɪkɑnəmaɪzɪŋ                    	 ɛkənɑmɪzɪŋ                     	 String Edit Distance 4  
tot                            	 tɑt                            	 tɔt                            	 String Edit Distance 1  
anglophile                     	 ængləfaɪl                      	 æŋgləfaɪl                      	 String Edit Distance 1  
alexanders                     	 ælɪgzændərz                    	 ælɛksəndərz                    	 String Edit Distance 4  
